愛	爱	ài	love, like, be fond of, be keen on, cherish, be apt to, affection, to be inclined (to do sth)
愛好	爱好	àihào	love, like, be fond of, be keen on
八	八	bā	det.: eight, 8
爸爸	爸爸	bàbà	old man, father, papa, pappa, daddy, pa, begetter, pop, dada, dad, male parent, pater, pappy, pops, poppa
吧	吧	ba	particle: used to show mild imperative or uncertainty, (modal particle indicating suggestion or surmise), ...right?
白	白	bái	white, clear, pure, plain, wrongly written/mispronounced, bright, to make clear, free of charge, reactionary, anti-communist, funeral, to write wrong character, spoken lines in opera
白天	白天	bái tiān	daytime, during the day, day, CL:個|个[ge4]
百	百	bǎi	cent, centum, century, hundred, det.: hundred, numerous, all kinds of
班	班	bān	m.[event], team, class, squad, work shift, ranking, classifier for groups
半	半	bàn	det.: half, semi-, incomplete, (after a number) and a half
半年	半年	bàn nián	half a year
半天	半天	bàn tiān	half of the day, a long time, quite a while, midair, CL:個|个[ge4]
幫	帮	bāng	help, to assist, to support, for sb (i.e. as a help), hired (as worker), side (of pail, boat etc), outer layer, gang, clique, secret society
幫忙	帮忙	bāngmáng	assist, aid, smile, lend a hand, do a favour, help, oblige, give a hand, do favor, do a good turn
包	包	bāo	wrap, surround, encircle, envelop, include, contain, undertake the whole thing, assure, guarantee, to cover, to contract (to or for), package, to hold or embrace
包子	包子	bāo zi	steamed stuffed bun, CL:個|个[ge4]
杯	杯	bēi	m.[container], cup, trophy cup, classifier for certain containers of liquids: glass, cup
杯子	杯子	bēizi5	tumbler, drinking glass, cup, glass
北	北	běi	atomic number 97, northward, north, berkelium, Bk, northern, to be defeated (classical)
北邊	北边	běi biān	north, north side, northern part, to the north of
北京	北京	běijīng	capital of Red China, Beijing, Peking, Beijing (Peking), Peiping
本	本	běn	det.: this, root, stem, origin, source, the current, classifier for books, periodicals, files etc, roots or stems of plants, foundation
本子	本子	běn zi	book, notebook, edition, CL:本[ben3]
比	比	bǐ	compared with, (particle used for comparison and “-er than”), to gesture (with hands)
別	别	bié	don’t, to leave, to distinguish, to classify, to stick (sth) in
別的	别的	bié de	else, other
別人	别人	biérén	others, other people, another person
病	病	bìng	disease, illness, to fall ill, defect
病人	病人	bìngrén	shut-in, patient, subject, sufferer, case, valetudinarian, invalid
不大	不大	bùdà	not very/too, not often
不對	不对	bù duì	incorrect, wrong, amiss, abnormal, queer
不客氣	不客气	bù kè qi	you’re welcome, don’t mention it, impolite, rude, blunt
不用	不用	búyòng	need not
不	不	bù	non, do not, no, nowise, not, nope, nae, no more, nix, (negative prefix)
菜	菜	cài	vegetable, greens, dish, course, food, dish (type of food), (coll.) (one’s) type, (of one’s skills etc) weak, CL:盤|盘, 道[dào]
茶	茶	chá	tea, tea plant, CL:杯, 壺|壶[hú]
差	差	chā	be short, lack
常	常	cháng	often, usually, frequently, always, ever, common, general, constant
常常	常常	chángcháng	oftentimes, ofttimes, commonly, ordinarily, oft, often, a great deal, normally, frequently, unremarkably, much, usually
唱	唱	chàng	cry, chant, chirm, tune, vocalize, call, sing, to call loudly
唱歌	唱歌	chànggē	sing
車	车	chē	vehicle, car, machine, to shape with a lathe
車票	车票	chēpiào	ticket (for train/bus)
車上	车上	chēshàng	Car
車站	车站	chēzhàn	station
吃	吃	chī	feed, have, be subject to, absorb, chow, live on, eat, have one’s meals, be a strain, exhaust, fare, take in, live off, annihilate, wipe out, partake, suffer, ingest, consume, graze, lunch, manducate, incur, take, get, use up, make, taste, soak up, to eat at (a cafeteria etc), to stammer (Taiwan pr. for this sense is [jí])
吃飯	吃饭	chīfàn	feed, dine, make a living, keep alive, have a meal, eat
出	出	chū	produce, turn out, arise, happen, to come out, to put forth, (used after a verb to indicate an outward direction or a positive result), classifier for dramas, plays, operas etc
出來	出来	chūlái	come forward, issue, come up, step up, step to the fore, out (toward one), come out, pop out, come out, rise, come to the fore, step forward, emergence, come forth, emerge
出去	出去	chūqù	go out, go/get out, get out, go out, get out, go, exit
穿	穿	chuān	to wear, to put on, to dress, to bore through, to pierce, to perforate, to penetrate, to pass through, to thread
床	床	chuáng	bed, couch, classifier for beds
次	次	cì	order, sequence, next, second, the second (day, time etc), vice-, sub-, infra-, inferior quality, substandard, hypo- (chemistry), classifier for enumerated events: time
從	从	cóng	from, since, through, via, to follow, to engage in (an activity), never (in negative sentence), (Taiwan pr. [zòng]) retainer, auxiliary, related by common paternal grandfather or earlier ancestor
錯	错	cuò	wrong, mistaken, bad, poor, confused, complex, interlocking, to grind, to polish, to alternate, to inlay with gold or silver
打	打	dǎ	generalized verb of doing with specific meaning determined by its object, strike, hit, fight, construct, forge, mix, to break, to play (a game)
打車	打车	dǎ chē	to take a taxi (in town), to hitch a lift
打電話	打电话	dǎdiànhuà	make telephone call
打開	打开	dǎkāi	unscrew, undo, break out, open up, unbar, unpack, unwind, shoot, turn, switch on, open, switch on, unroll, turn/switch on, unclose, straighten, unfold, crack, unwrap, ope, turn on, turn on, chop
打球	打球	dǎqiú	play a ball game using arms/hands
大	大	dà	great, macro, old, very, vast, tall, big, high, much, large, wide, deep, older (than), very much, (dialect) father, father’s elder or younger brother
大學	大学	dàxué	university, college
大學生	大学生	dàxuéshēng	man, university/college student, college man, university student, colleger, university, undergrad, undergraduate, college boy, college student, collegian, university student, undergraduate student, geeks
到	到	dào	up until, to (a place), until (a time), (verb complement denoting completion or result of an action)
得到	得到	dé dào	to get, to obtain, to receive
地	地	dì	the earth, land, soil, fields, ground, place, position, background, distance
的	的	de	particle: emphasizing an action/situation, of, ~’s (possessive particle), (used after an attribute), (used to form a nominal expression), (used at the end of a declarative sentence for emphasis)
等	等	děng	conj.: and so on, etc, rank, grade, equal to, same as, to wait for, et cetera, et al. (and other authors), once
地點	地点	dìdiǎn	location, site, locale, locality, topographic point, point, venue, spot, situs, land site, place, locus
地方	地方	dìfāng	country, soil, terrain, part, clime, way, territory, room, neighbourhood, tinderbox, locality (as distinct from the central administrat, child, tract, province, position, respect, where, region, space, place, local
地上	地上	dì shang	on the ground, on the floor
地圖	地图	dìtú	map
弟弟	弟弟	dìdì	brother, little brother, younger brother, cadet, little brother, viscount
第	第	dì	mansion, stadium, decker, det.: marker of ordinal numerals, abomasum, residence, (prefix indicating ordinal number, e.g. first, number two etc), (old) rank in the imperial examinations
點	点	diǎn	m.[proximation], drop, speck, o’clock, point (in space or time), to check on a list, to order (food in a restaurant), to touch briefly, to pour a liquid drop by drop, (old) one fifth of a two-hour watch 更[gēng], dot stroke in Chinese characters, classifier for items
電	电	diàn	electricity
電話	电话	diànhuà	blower, phone call, headphone, earpiece, telephone, telephone call, buzz, earphone, horn, telephone set, phone call, telephony, phone
電腦	电脑	diànnǎo	electronic computer, computery, data processor, information processing system, computer
電視	电视	diànshì	TV, box, iconoscope, video, television set, teevee, orthicon, huckster, TV set, radiovision, television, telecasting, airwave, telly
電視機	电视机	diànshìjī	set, idiot box, tv, goggle-box, idiot box, television receiver/set, teleset, television set, television receiver, TV set, goggle box, tv set, goggle box, boob tube, receiver, telly, television
電影	电影	diànyǐng	cinematography, moving picture, pix, kinema, picture, film, movie, moving picture, flick, cinema, motion picture, cinematic, celluloid, picture show, motion picture, flicker
電影院	电影院	diànyǐngyuàn	cinema, movie (house)
東	东	dōng	east, host (i.e. sitting on east side of guest), landlord
東邊	东边	dōng bian	east, east side, eastern part, to the east of
東西	东西	dōngxī	thing, creature
動	动	dòng	concuss, get moving, travel, go, use, eat or drink, act, arouse, stir, disturb, alter, touch, change, dynamic, locomote, move, (of sth) to move, to displace, to make use of, to stir (emotions), abbr. for 動詞|动词[dòng cí], verb
動作	动作	dòngzuò	demeanor, motion, behavior, performance, demeanour, play, turn, operation, operative, looseness, agency, gesticulation, movement, gesture, comportment, business, action, move
都	都	dōu	all, even, already, both, entirely, (used for emphasis) even, (not) at all
讀	读	dú	study, read, attend school, take, read aloud, read (aloud), peruse, reading of word (i.e. pronunciation), similar to 拼音[pīn yīn]
讀書	读书	dúshū	read, study, attend school
對	对	duì	correct, true, toward, right, couple, pair, at, to face, opposite, to treat (sb a certain way), to match together, classifier: couple
對不起	对不起	duìbùqǐ	be unfair to, I’m sorry, let ... down, let sb. down, excuse me
多	多	duō	many, much, more, more than the correct/required number, excessive, too much, much/far more, multi-, Taiwan pr. [duó] when it means “how”
多少	多少	duōshǎo	det.: how many, how much, many
餓	饿	è	starve, to be hungry, to starve (sb)
兒子	儿子	érzi	viscount, man-child, boy, male offspring, son
二	二	èr	det.: two, second, 2, (Beijing dialect) stupid
飯	饭	fàn	food, meal, repast, cooked rice or other cereals, dinner, (loanword) fan
飯店	饭店	fàndiàn	restraurant, restaurant, hotel
房間	房间	fángjiān	apartment, aspect, houseroom, room, chamber, bedroom
房子	房子	fángzi	building (of less than three stories), room, building, property, house
放	放	fàng	loose, bloom, make longer, set ... free, let sb. have his own way, show, readjust, free, make larger, put in, fly, etc., release, discharge, leave alone, bung, lay aside, put, expansion, make longer/larger/etc., fling, localize, lend (money) at interest, let go, set, pasture, pose, set free, blossom, lay, let off, put out to pasture, send away, play, expand, make larger/etc., readjus, to set off (fireworks)
放假	放假	fàngjià	have a day off, have a vacation, have day off, have or be on vacation, have or be on holiday, have a holiday, vacation
放學	放学	fàngxué	have winter holidays, classes are over, finish classes, have summer holidays, finish classes (for the day)
飛	飞	fēi	hover in the air, flight, hover, volatilize, wing, disappear through volatilization, flutter, skip, hover/flutter in the air, fly, blow, flutter in the air, flit
飛機	飞机	fēijī	aerocraft, airplane, machine, craft, aeroplane, ship, aero, avion, aeronef, plane, aircraft
非常	非常	fēicháng	extraordinary, unusual, special, very, extremely, highly
分	分	fèn	m.[general]
風	风	fēng	wind, common practice, custom, general mood, style, news, information, manner
幹	干	gàn	do, work, fight, tree trunk, main part of sth, to manage, capable, to kill (slang)
乾淨	干净	gānjìng	clean, clear
幹什麼	干什么	gànshénmo5	do something
高	高	gāo	tall, high, above average, loud, your (honorific)
高興	高兴	gāoxìng	glad, happy, cheerful, merry, pleased
告訴	告诉	gàosù	tell, preach, notify, impart, inform, represent, apprize, send word, share, advise, give notice, apprise, assure, let know
哥哥	哥哥	gēgē	big brother, elder brother, big brother
歌	歌	gē	song, to sing
個	个	gè	piece, item, individual, this, size, classifier for people or objects in general, variant of 個|个[gè]
給	给	gěi	give, give to, for, for the benefit of, to allow, to do sth (for sb), (grammatical equivalent of 被), (sentence intensifier)
跟	跟	gēn	with, to, from, heel, to follow closely, to go with, (of a woman) to marry sb, compared with, and (joining two nouns)
工人	工人	gōngrén	navvy, hired man, operative, working person, laborer, shopworker, esne, working man, hired hand, worker, workpeople, workman, hand
工作	工作	gōngzuò	work, job
關	关	guān	shut, close, turn off, lock up, close down, mountain pass, to concern, to involve
關上	关上	guān shàng	to close (a door), to turn off (light, electrical equipment etc)
貴	贵	guì	expensive, costly, highly valued, noble, precious, (honorific) your
國	国	guó	surname Guo, country, nation, state, national, CL:個|个[ge4]
國家	国家	guójiā	sirkar, state, country, patria, a people, nationality, nation, republic, soli, body politic, clime, national, civil order, polity, commonwealth, land, res publica
國外	国外	guówài	overseas
過	过	guò	[aspect], to cross, to go over, to pass (time), to celebrate (a holiday), excessively
還	还	hái	still, yet, also, too, as well, besides, still in progress, in addition, fairly, passably (good), even
還是	还是	háishì	still, nevertheless
還有	还有	háiyǒu	conj.: furthermore, in addition
孩子	孩子	háizi	kid, issue, chap, daughter, children, sonny, son or daughter, child, spawn, boy, kipper, son
漢語	汉语	Hàn yǔ	Chinese language, CL:門|门[men2]
漢字	汉字	hàn zì	Chinese character, CL:個|个[ge4], Japanese: kanji, Korean: hanja, Vietnamese: hán tự
好	好	hǎo	good, well, proper, easy to, very, (suffix indicating completion or readiness), (after a personal pronoun) hello
好吃	好吃	hǎochī	delicious, good to eat, tasty, enjoy eating good food, gluttonous
好看	好看	hǎokàn	embarrassed, interesting, nice, good-looking, delightful
好聽	好听	hǎotīng	pleasant to hear
好玩兒	好玩儿	hǎowánr	interesting, delightful, amusing
號	号	hào	m.[general], ordinal number, day of a month, mark, sign, business establishment, ship suffix, horn (wind instrument), assumed name, to take a pulse, classifier used to indicate number of people
喝	喝	hē	drink, My goodness!
和	和	hé	and, with, gentle, peaceful, together with, sum, union, harmony, Taiwan pr. [hàn] when it means “and” or “with”
很	很	hěn	pretty, thrice, monstrously, gey, quite, mighty, stinking, sopping, some, assai, full, most, clinking, much, thumping, awfully, fiendishly, thundering, very, real, really, bally, proper, grossly, powerful, so, rattling, well, considerably, greatly, terribly, (adverb of degree)
後	后	hòu	rear, back, behind, afterwards, post-
後邊	后边	hoù bian	back, rear, behind
後天	后天	hoù tiān	the day after tomorrow, post-natal, acquired (not innate), a posteriori
花	花	huā	spend, expend, cost, flower, blossom, fancy pattern, to spend (money, time), (coll.) lecherous, lustful
話	话	huà	words, thing, language, tongue, talk, speech, spoken language, conversation, utterance, expression, story, tale, saying, natural language, sayings, word, dialect, spoken words, what sb said
壞	坏	huài	spoiled, bad, broken, to break down, (suffix) to the utmost
回	回	huí	return, go back, to circle, to turn around, Hui ethnic group (Chinese Muslims), classifier for acts of a play, section or chapter (of a classic book)
回答	回答	huídá	answer, reply
回到	回到	huídào	remount, retour, recur, turn back, regress, regain, revert, go back, return to, return, go back to
回家	回家	huíjiā	return home
回來	回来	huílái	come back, get back, recur, revisit, come, return, be back, come back
回去	回去	huíqù	go home, go back, retrocede, go back, be back, go, return
會	会	huì	to be able, can, will, to meet, union, group, association, a moment (Taiwan pr. for this sense is [huǐ]), be likely to, CL:個|个[gè]
火車	火车	huǒchē	choo-choo, railroad train, car train, marshalling yard, puff-puff, train
機場	机场	jīchǎng	landing field, flying field, airfield, airport, airdrome, field, aerodrome
機票	机票	jī piào	air ticket, passenger ticket, CL:張|张[zhang1]
雞蛋	鸡蛋	jī dàn	(chicken) egg, hen’s egg, CL:個|个[ge4], 打[da2]
幾	几	jǐ	det.: how many, a few, several, some
記	记	jì	write down, record, to note, to memorize, mark, sign, classifier for blows, kicks, shots
記得	记得	jìde	come to mind, think back, remember, recollect, recall, rememberance, mind, retain, place, spring to mind, bear in mind
記住	记住	jì zhu	to remember, to bear in mind, to learn by heart
家	家	jiā	family, household, home, house, (polite) my (sister, uncle etc), classifier for families or businesses, refers to the philosophical schools of pre-Han China, noun suffix for a specialist in some activity, such as a musician or revolutionary, corresponding to English -ist, -er, -ary or -ian, CL:個|个[gè]
家裡	家里	jiā lǐ	home
家人	家人	jiārén	relation, homefolk, inmate, kindred, household, relative, people, folks, kin, family members, family, kinsfolk, house
間	间	jiān	locality, room, between, among, within a definite time or space, section of a room or lateral space between two pairs of pillars
見	见	jiàn	see, be exposed to, become visible, call on, refer to, meet with, appear to be, appear, vide, catch sight of, meet, to interview
見面	见面	jiànmiàn	meet, see
教	教	jiāo	teach
叫	叫	jiào	to be called, to shout, to order, by (indicates agent in the passive mood)
教學樓	教学楼	jiào xué loú	teaching block, school building
姐姐	姐姐	jiějiě	sis, big sister, elder sister, sister
介紹	介绍	jièshào	introduce, present, recommend, suggest, let know, brief
今年	今年	jīn nián	this year
今天	今天	jīn tiān	today, at the present, now
進	进	jìn	enter, come/go into, advance, to go forward, to put in, (math.) base of a number system, classifier for sections in a building or residential compound
進來	进来	jìnlái	come in, enter
進去	进去	jìnqù	enter, entry, go in, get in, go in
九	九	jiǔ	det.: nine, 9
就	就	jiù	then, at once, right away, an indicator strengthening speaker’s evaluation, just (emphasis), to accomplish, to go with (of foods)
覺得	觉得	juéde	imagine, guess, believe, reckon, suspect, suppose, think, listen, feel, consider, think of, appear, conceive
開	开	kāi	open, open up, reclaim (land), open out, come loose, start, begin, operate, turn on (light), run (business), hold (meeting/etc.), divide into, reveal, to write out (a prescription, check, invoice etc), abbr. for Kelvin, 開爾文|开尔文[kāi ěr wén]
開車	开车	kāi chē	to drive a car
開會	开会	kāihuì	hold/attend meeting
開玩笑	开玩笑	kāiwánxiào	kid, spoof, jive, gag, make fun of, josh, daff, rot, quip, chaff, rib, banter, jolly, fun, sport, put on, clown, fool, droll, jape, joke, skylark, jest, jocose, crack a joke
看	看	kàn	see, look at, watch, read, look upon, regard, look after, call on, visit, to consider, to treat (an illness), (after verb) to give it a try, Watch out! (for a danger), depending on (how you’re judging)
看病	看病	kàn bìng	to visit a doctor, to see a patient
看到	看到	kàndào	view, receive, ken, observe, lamp, catch, see, take in, watch, chatter away, lay eyes on, boast, brag, shoot the breeze, spy, catch sight of, catch sight of
看見	看见	kànjiàn	seeing, behold, see, descry, show, perceive, lay eyes on, lamp, spy, show up, sight, catch sight of, catch sight of
考	考	kǎo	study, inspect, give test, inspection, give, give/take test, test, investigate, verify, take test, give or take an examination, quiz, check, deceased father
考試	考试	kǎoshì	examination, test
渴	渴	kě	thirsty
課	课	kè	subject, course, class, lesson, to levy, tax, form of divination
課本	课本	kèběn	text edition, textbook, text, school text, schoolbook
課文	课文	kè wén	text, CL:篇[pian1]
口	口	kǒu	m.[general], mouth, classifier for things with mouths (people, domestic animals, cannons, wells etc)
塊	块	kuài	m.[general], lump (of earth), chunk, piece, classifier for pieces of cloth, cake, soap etc, (coll.) classifier for money and currency units, colloquial word for yuan (or other unit of currency such as Hong Kong or US dollar etc), usually as 塊錢|块钱
快	快	kuài	fast, quick, quick-witted, ingenious, sharp (of knives), straightforward, almost, to make haste, clever, plainspoken
來	来	lái	to, to come, to arrive, ever since, next
來到	来到	láidào	arrive, come
老	老	lǎo	old, aged;of long standing, outdated, tough, overgrown, dark (of colors), prefix used before the surname of a person or a numeral indicating the order of birth of the children in a family or to indicate affection or familiarity
老人	老人	lǎorén	oldster, ancient, old woman, crock, one’s aged parents or grandparents, old man/woman, one’s aged parents/grandparents, Sir, old person, gaffer, pop, one’s aged parents, the aged/old, old man, senior citizen, oldie, greybeard, old man, graybeard, old, grandparents, the old, the aged, senior citizen, old boy, old boy, woman, old-timer, old man or woman, one’s aged grandparents
老師	老师	lǎoshī	rabbi, professor, swami, instructor, teacher, mast
了	了	le	entirely, (modal particle intensifying preceding clause)
累	累	lèi	tire, build by piling up, pile up, strain, weary, toil, accumulate, involve, tired, burthen, work hard, accumulation, fatigued, wear out
冷	冷	lěng	cool, rare, cold, unfrequented, feel cold, chill, frosty(in manner), shot from hiding, strange
裡	里	lǐ	inside, lining, interior, also written 裏|里[lǐ], li (Chinese mile), 500 meters (modern), village, neighborhood, administrative unit
裡邊	里边	lǐ bian	inside
兩	两	liǎng	det.: two, both (sides), either (side), a few, some, tael, unit of weight equal to 50 grams (modern) or 1⁄16 of a catty 斤[jīn] (old)
零	零	líng	det.: zero, naught, nil, zero sign, fractional, fragmentary, odd (of numbers), (placed between two numbers to indicate a smaller quantity followed by a larger one)
六	六	liù	det.: six, 6
樓	楼	lóu	storey, Lou, tower, superstructure, storied building, story, floor, Surname, a storied building, house with more than 1 story
樓上	楼上	loú shàng	upstairs
樓下	楼下	loú xià	downstairs
路	路	lù	road, path, way, journey, distance, means, sequence, logic, line, region, district, route, sort, grade, class, line (bus etc)
路口	路口	lù koǔ	crossing, intersection (of roads)
路上	路上	lù shang	on the road, on a journey, road surface
媽媽	妈妈	māmā	mummy, mammy, ma, mother, mamma, mum, mommy, female parent, mom, Mama, mater, mama, momma
馬路	马路	mǎlù	drive, road, driveway, riding, a road, carriageway, avenue, street, a street used by vehicular traffic
馬上	马上	mǎshàng	in a short time, at once, instantaneously, promptly, at once, incontinent, in the same breath, directively, instantly, slapbang, pronto, right away, immediately, shortly, without delay, right away, tout-de-suite, forthwith, presently, in no time, at a time, soon, hereupon, in a few seconds, before long, at one time, outright, straightaway, in a minute, directly, momently, in a f
嗎	吗	mā	particle: calling for agreement or disagreement
買	买	mǎi	pick up, invest, hire, buy, purchase, put down, trade, get
慢	慢	màn	tardy, rude, slow down, slow, slow up, retard, lose, defer, supercilious, postpone, decelerate
忙	忙	máng	hurry, hasten, busy, to rush
毛	毛	máo	Mao, wool, bristle, nap, pilus, down, feather, mold, mildew, Surname, hair, 1 1 0 th yuan, 1 0 th yuan, dime, silk, cent, fur, marking, coarse or semifinished, unthinking, nervous, (of currency) to devalue or depreciate, classifier for Chinese fractional monetary unit ( = 角[jiǎo] , = one-tenth of a yuan or 10 fen 分[fēn])
沒	没	méi	not, (negative prefix for verbs)
沒關係	没关系	méiguānxì	it doesn’t matter, never mind
沒甚麼	没什么	méi shén me	nothing, it doesn’t matter, it’s nothing, never mind
沒事兒	没事儿	méishìr	to have spare time, free from work, it’s not important, it’s nothing, never mind
沒有	没有	méiyǒu	not have, there is not, be without
妹妹	妹妹	mèimèi	little sister, sis, younger sister, little sister, sister
門	门	mén	door, gate, opening, valve, switch, way to do something, knack, family, (religious) sect, school (of thought), category, phylum or division (taxonomy), classifier for large guns, classifier for lessons, subjects, branches of technology, (suffix) -gate (i.e. scandal
門口	门口	ménkǒu	porch, portal, doorway, gateway, threshold, room access, door, entering, entrance
門票	门票	ménpiào	entrance/admission ticket, admission ticket, admission fee, admission price, entrance ticket, admission charge, cover charge, admission, entrance fee, entrance money, pasteboard, price of admission, entrance
們	们	men	pluralizer after pronouns and nouns of persons
米飯	米饭	mǐ fàn	(cooked) rice
麵包	面包	miànbāo	bun, staff of life, cookie, breadstuff, bread
麵條兒	面条儿	miàntiáor	noodles, erhua variant of 麵條|面条[mian4 tiao2]
名字	名字	míngzi	first name, forename, moniker, monaker, first name, monicker, cognomen, given name, name, patronymic, appellation
明白	明白	míngbái	clarify, downright, recognize, agnize, tumble, follow, make out, catch, understand, discern, think, know, seize, agnise, twig, realize, get, realization
明年	明年	míng nián	next year
明天	明天	míng tiān	tomorrow
拿	拿	ná	take, hold, seize, capture, to catch, to apprehend, (used in the same way as 把[bǎ]: to mark the following noun as a direct object)
哪	哪	nǎ	det.: which, how
哪裡	哪里	nǎlǐ	where
哪兒	哪儿	nǎér	where
哪些	哪些	nǎxiē	det.: which
那	那	nà	det.: that, those, then (in that case), commonly pr. [nèi] before a classifier, esp. in Beijing
那邊	那边	nàbiān	beyond, that side, there
那裡	那里	nàlǐ	that place
那兒	那儿	nǎēr	that place
那些	那些	nǎxiē	det.: those
奶	奶	nǎi	breasts, milk, to breastfeed
奶奶	奶奶	nǎinǎi	nanna, address for married woman, granny, gran, grandmother, grandma, respectful form of address for an old woman, paternal grandmother
男	男	nán	baron, male, man, steady, mankind, male person, boy, chauvinism, creature, son, Baron, lowest of five orders of nobility 五等爵位[wǔ děng jué wèi]
男孩兒	男孩儿	nánháir	boy, erhua variant of 男孩[nan2 hai2]
男朋友	男朋友	nánpéngyǒu	boyfriend
男人	男人	nánrén	male, man, chap, mankind, buck, bastard, gentleman, jack, gent, men, blighter, cuss, hombre, lad, adult male, groom, husband, bimbo, dog, fellow, mon, menfolk, fella
男生	男生	nánshēng	brother, sonny boy, man, male, laddie, lad, boy student, male student, boy, schoolboy, sonny, cub, man student
南	南	nán	Yugoslavia, South, Nan, south, Surname, S, due south, austral, southern
南邊	南边	nán bian	south, south side, southern part, to the south of
難	难	nán	make difficulties, take to task, put ... into a difficult position, disagreeable, make difficult, unpleasant, hard, difficult, troublesome, blame
呢	呢	ne	particle: marking quesitons about subject already mentioned; indicating strong affirmation, particle indicating that a previously asked question is to be applied to the preceding word (“What about ...?”, “And ...?”), particle signaling a pause, to emphasize the preceding words and allow the listener time to take them on board (“ok?”, “are you with me?”), (at the end of a declarative sentence) particle indicating continuation of a state or action
能	能	néng	can or to be capable of, might possibly, ability, (physics) energy, (usually used in the negative) to have the possibility of
你	你	nǐ	you, you (informal, as opposed to courteous 您[nín])
你們	你们	nǐmen	you, you (plural), you-all
年	年	nián	year, CL:個|个[gè]
您	您	nín	you, you (courteous, as opposed to informal 你[nǐ])
牛奶	牛奶	nióunǎi	cow’s milk
女	女	nǔ	girl, female, woman, neodymium, hen, daughter, beaver, creature
女兒	女儿	nǔér	daughter, girl
女孩兒	女孩儿	nǚháir	girl, erhua variant of 女孩[nu:3 hai2]
女朋友	女朋友	nǔpéngyǒu	jane, girl, girl friend, lady friend, girlfriend, amie
女人	女人	nǔrén	jade, crumpet, female, female person, Gill, bitch, chick, fair, squaw, womenfolk, adult female, doll, momma, wench, skirt, womankind, girl, jill, wife, broad, petticoat, sister, woman, bimbo, bird, jane, she, hen, hairpin, dame, women
女生	女生	nǔshēng	schoolgirl, girl student, female student, female, girl, woman student, co-ed
旁邊	旁边	pángbiān	by the side of, side, adjacency, near by
跑	跑	pǎo	travel, race, be away, escape, course, run errands, skirr, double, walk, be away/off, run away, be off, run about doing sth., run, drive, paw the earth, run about doing ..., ride, leg, to run around (on errands etc), (of a gas or liquid) to leak or evaporate, (verb complement) away
朋友	朋友	péngyou	amigo, connections, kith, friend, boy, crony, ami, boy/girl friend, companion, mate, boy friend or girl friend, compadre, boy friend, Mac, paisano, matey, old boy, sport, folks, pard, hearty, Kamerad, cocker, cobber, girl friend, pardner, company
票	票	piào	ticket, ballot, note, person held for ransom, amateur performance of Chinese opera, classifier for groups, batches, business transactions
七	七	qī	det.: seven, 7
起	起	qǐ	[aspect], to rise, to get up, to start, to launch, to initiate (action), to get (from a depot or counter), verb suffix, to start, starting from (a time, place, price etc), classifier for occurrences or unpredictable events: case, instance
起床	起床	qǐchuáng	uprise, get up from bed, arise, get out of bed, turn out, rise, deck, get up, awake, get up
起來	起来	qǐlái	[aspect]
汽車	汽车	qìchē	automotive vehicle, machine, wheels, motorcar, motor vehicle, car, automotive, auto, wheel, autocar, motor, automobile, hoot, mobile, bus
前	前	qián	front, forward, ahead, top (followed by a number), future, ago, before, BC (e.g. 前293年)
前邊	前边	qián bian	front, the front side, in front of
前天	前天	qián tiān	the day before yesterday
錢	钱	qián	copper coin, cash, money, fund, sum, unit of weight, one tenth of a tael 兩|两[liǎng], CL:筆|笔[bǐ]
錢包	钱包	qián bāo	purse, wallet
請	请	qǐng	request, ask (a favor), engage, hire (teacher/etc.), Please..., to ask, to invite, please (do sth), to treat (to a meal etc)
請假	请假	qǐngjià	vacate, ask for leave
請進	请进	qǐng jìn	’please come in’
請問	请问	qǐngwèn	Excuse me, may I ask...?
請坐	请坐	qǐng zuò	Sitting, please have a seat
球	球	qiú	ball, sphere, globe, ball game, match
去	去	qù	to go, to leave, in order to, to go to (a place), (of a time etc) last, just passed, to be apart from in space or time, (when used either before or after a verb) to go in order to do sth, (after a verb of motion indicates movement away from the speaker), (of a time or an event etc) just passed or elapsed
去年	去年	qù nián	last year
熱	热	rè	hot, to warm up, hot (of weather), fervent
人	人	rén	person, people, man, CL:個|个, 位[wèi]
認識	认识	rènshì	know, recognize
認真	认真	rènzhēn	serious, earnest, take for real
日	日	rì	m.[standard], date, day of the month, abbr. for 日本 Japan
日期	日期	rìqí	calendar, when, date
肉	肉	ròu	pulp, chilli, cabobs, meat, lobscouse, paella, meaty, fleshy, flesh, marmite, pulp (of a fruit), (of a person) flabby, irresolute
三	三	sān	det.: three, 3
山	山	shān	Shan, jebel, pike, mountain, whitethorn, hump, anything resembling a mountain, gable, kop, chimney, hill, Surname, mount, bundled straw in which silkworms spin cocoons
商場	商场	shāngchǎng	department store, bazar, line of business, field of operation, grocery store, emporium, bazaar, grocery, mall, commercial circle, field, market
商店	商店	shāngdiàn	concern, hospital, business, store, shoppe, shop
上	上	shàng	on, above, on top, upper, previous, first (of multiple parts), to attend (class or university)
上班	上班	shàngbān	start work, go to work, be on duty
上邊	上边	shàng bian	the top, above, overhead, upwards, the top margin, above-mentioned, those higher up
上車	上车	shàng chē	to get on or into (a bus, train, car etc)
上次	上次	shàng cì	last time
上課	上课	shàngkè	attend class, go to class;give lesson/lecture
上網	上网	shàng wǎng	to go online, to connect to the Internet, (of a document etc) to be uploaded to the Internet, (tennis, volleyball etc) to move in close to the net
上午	上午	shàng wǔ	morning, CL:個|个[ge4]
上學	上学	shàngxué	attend school, be at school
少	少	shǎo	lack, be deficient, lose, be missing, to stop (doing sth), seldom, little
誰	谁	shéi	who, someone, anyone, also pr. [shuí]
身上	身上	shēn shang	on the body, at hand, among
身體	身体	shēntǐ	soma, system, physical structure, body, health, carcase, corpus, frame, person, somatic, organic structure, personage
什麼	什么	shéme	anything, what
生病	生病	shēngbìng	come down, ail, fall ill, traik, sick, sicken
生氣	生气	shēngqì	get angry, be angry
生日	生日	shēngrì	birthday
十	十	shí	det.: ten, 10
時候	时候	shíhòu	day, moment, (a point in) time, (duration of) time, time
時間	时间	shíjiān	moment, day, clock time, fourth dimension, relativity, hour, duration, time, when, while, temporal, economy
事	事	shì	responsibility, trouble, event, thing, worry, accident, case, involvement, work, affair, job, concern, business, toast, matter
試	试	shì	offer, attempt, essay, flesh, try, seek, assay, test, experiment, examination
昰	是	shì	is, are, am, yes, to be, variant of 是[shi4], (used in given names)
是不是	是不是	shì bù shì	is or isn’t, yes or no, whether or not
手	手	shǒu	hand, (formal) to hold, person engaged in certain types of work, classifier for skill
手機	手机	shoǔ jī	cell phone, mobile phone, CL:部[bu4],支[zhi1]
書	书	shū	volume, document, style of calligraphy, book, script, letter, to write, CL:本, 冊|册, 部[bù], see also 書經|书经 Book of History
書包	书包	shūbāo	bag, book bag, satchel, schoolbag
書店	书店	shūdiàn	bookstore
樹	树	shù	wood, Ruptiliocarpon caracolito, tree, arbor, Surname, caracolito, to set up
水	水	shuǐ	water, H2O, liquid, bubble, a general term for rivers, lakes, seas, etc., Shiu, waters, aqueous, Aquarius, river, Surname, blister, drink, eau, aqua, additional charges or income, (of clothes) classifier for number of washes
水果	水果	shuǐguǒ	fruit
睡	睡	shuì	sleep, to lie down
睡覺	睡觉	shuìjiào	turn in, log Z’s, doss, slumber, catch some Z’s, go to bed, sleep, doss down, crash, go to sleep, hit the sack, kip
說	说	shuō	speak, talk, explain, scold, to say, to tell off, a theory (typically the last character in a compound, as in 日心說|日心说 heliocentric theory)
說話	说话	shuōhuà	philosophize, thrum, talk, peach, babble out, speech, articulate, chat, speak, babble, gossip, blab out, sing, address, tattle, blab, mouth, say
四	四	sì	det.: four, 4
送	送	sòng	accompaniment, escort, see sb. off, see sb. off/out, to dispatch, see ... off, accompany, to deliver, send, direct, serve, guide, give as a present, deliver, see sb. out, see, lead, see ... out, conduct, give, to send, carry, delivery, carriage, take, hospitalize, to present (with)
歲	岁	suì	year (for crops), m.[standard], , year of age, year (of age), year, annum, year for crops, classifier for years (of age)
他	他	tā	he, she, it, they (referring to inanimate things in object position), (used for either sex when the sex is unknown or unimportant)
他們	他们	tāmen	they
她	她	tā	she, her, she (neologism for {1ta1}[2]), )
她們	她们	tāmen	they (female)
太	太	tài	excessively, too, extremely, very, highest, greatest, too (much)
天	天	tiān	m.[standard], sky, heaven
天氣	天气	tiānqì	sky, elements, weather condition, atmospheric condition, weather
聽	听	tīng	hear, list, hearken, obey, obedience, listen, heed, administer, let, allow, hark, a can (loanword from English “tin”), classifier for canned beverages
聽到	听到	tīngdào	hear
聽見	听见	tīngjiàn	hear
聽寫	听写	tīng xiě	dictate, dictation, CL:次[ci4], (of a pupil) to write down (in a dictation exercise)
同學	同学	tóngxué	class fellow, fellow student, condisciple, classmate, schoolmate, schoolfellow, form of address used in speaking to a student
圖書館	图书馆	túshūguǎn	library
外	外	wài	outside, in addition, foreign, external
外邊	外边	wài bian	outside, outer surface, abroad, place other than one’s home
外國	外国	wàiguó	foreign, foreign country, outland, outremer
外語	外语	wàiyǔ	foreign language
玩兒	玩儿	wánr	to play, to have fun, to hang out
晚	晚	wǎn	far on in time, late, evening
晚飯	晚饭	wǎn fàn	evening meal, dinner, supper, CL:份[fen4], 頓|顿[dun4], 次[ci4], 餐[can1]
晚上	晚上	wǎn shang	evening, night, CL:個|个[ge4], in the evening
網上	网上	wǎng shàng	online
網友	网友	wǎng yoǔ	online friend, Internet user
忘	忘	wàng	forget, overlook, neglect
忘記	忘记	wàngjì	misremember, block, blank out, neglect, overlook, draw a blank, leave out, disremember, fail, forget
問	问	wèn	ask, examine, question, interrogate
我	我	wǒ	I, me, ego, self
我們	我们	wǒmen	we
五	五	wǔ	det.: five, 5
午飯	午饭	wǔ fàn	lunch, CL:份[fen4], 頓|顿[dun4], 次[ci4], 餐[can1]
西	西	xī	W, Spain, west, occident, due west, western
西邊	西边	xī biān	west, west side, western part, to the west of
洗	洗	xǐ	wash, bathe, sack, develop (film), shuffle (cards/etc.)
洗手間	洗手间	xǐ shoǔ jiān	toilet, lavatory, washroom
喜歡	喜欢	xǐhuān	like, love, be fond of, be happy/elated
下	下	xià	under (condition/fact etc.), downwards, below, to go down, to arrive at (a decision, conclusion etc), measure word to show the frequency of an action
下班	下班	xiàbān	get off
下邊	下边	xià bian	under, the underside, below
下車	下车	xiàchē	get off/out of vehicle
下次	下次	xià cì	next time
下課	下课	xiàkè	finish class, get out of class
下午	下午	xià wǔ	afternoon, CL:個|个[ge4], p.m.
下雨	下雨	xiàyǔ	rain
先	先	xiān	earlier, in advance, before, first
先生	先生	xiānshēng	doctor of Chinese medicine, Don, mulla, Ms., sir., teacher, gentleman, gospodin, Signor, signor, fortune-teller, babu, baboo, Herr, Mister, bey, mister, bwana, husband, siree, buckra, sirrah, senor, guv, sahib, Mr., rabbi, don, signore, Dan, sir, m’sieur, effendi, Tuan, baas, Monsieur, lording, monsieur, doctor, Mr, milord, Mynheer, signior, esquire, bookkeeper, Senor, rabboni, Senhor, sieur, sen
現在	现在	xiàn zài	now, at present, at the moment, modern, current, nowadays
想	想	xiǎng	think, suppose, reckon, consider, want to, would like to, feel like (doing sth.), to believe, to miss (feel wistful about the absence of sb or sth)
小	小	xiǎo	small, little, petty, minor;young, few
小孩兒	小孩儿	xiǎoháir	child, erhua variant of 小孩[xiao3 hai2]
小姐	小姐	xiǎojiě	Signorina, Senorita, senorita, signorina, young lady, damosel, Dona, mum, young lady, damoiselle, missy, tootsy, demoiselle, damsel, Miss, Fraulein, miss, sheila, sister, toots, senhorita, damozel, Ladyship, ladyship, Mademoiselle, mademoiselle
小朋友	小朋友	xiǎopéngyǒu	child (adult address to child), little boy, children, little boy/girl, girl, little girl, little boy or girl, child
小時	小时	xiǎoshí	hour
小學	小学	xiǎoxué	primary school, elementary school
小學生	小学生	xiǎoxuéshēng	(primary) pupil, schoolboy, schoolgirl
笑	笑	xiào	smile, laugh
寫	写	xiě	description, bewrite, direct, describe, pencil, draw, paint, inscribe, write, depiction, write out, throw off, depict, address, author, screeve, word, compose
謝謝	谢谢	xièxiè	thank
新	新	xīn	new, fresh, up-to-date, meso- (chemistry)
新年	新年	xīn nián	New Year, CL:個|个[ge4]
星期	星期	xīngqí	Sunday, week
星期日	星期日	Xīng qī rì	Sunday, CL:個|个[ge4]
星期天	星期天	Xīng qī tiān	Sunday, CL:個|个[ge4]
行	行	xíng	go, travel, prevail, circulate, be current, to walk, a visit, temporary, makeshift, to perform, capable, competent, effective, all right, OK!, will do, behavior, Taiwan pr. [xìng] for the behavior-conduct sense
休息	休息	xiūxí	repose, have, lie dormant, respire, take time off, have a rest, take a rest, take off, relax, take time off, have/take a rest, rest
學	学	xué	study, learn, imitate, mimic, science, -ology
學生	学生	xuéshēng	academic, pupil, pup, tutee, follower, scholar, schoolchild, schoolboy, alumnus, disciple, learner, scholastic, student
學習	学习	xuéxí	study, learn, emulate
學校	学校	xuéxiào	seminary, schoolhouse, educational institution, school, institution
學院	学院	xuéyuàn	seminary, college, school, hall, institute, academy, faculty
要	要	yào	want, need, must, should, important, to ask for, will, going to (as future auxiliary), (used in a comparison) must be, probably, either… or…
爺爺	爷爷	yéyé	grandad, Grandpa, granddad, grandpa, (paternal) grandfather, gramps, granddaddy, grandfather
也	也	yě	also, too, as well, either, even, (in Classical Chinese) final particle implying affirmation
頁	页	yè	page, leaf, m.[general], , sheet of paper, sheet, piece, piece of paper, folio
一	一	yī	det.: one, 1, single, a (article), as soon as, entire, whole, throughout, “one” radical in Chinese characters (Kangxi radical 1), also pr. [yāo] for greater clarity when spelling out numbers digit by digit
衣服	衣服	yīfú	clothes, wearing apparel, toggery, gear, tog, wear, bib-and-tucker, drapery, thing, dress, duds, vestment, wardrobe, clout, apparel, clothing, dud, wrapping, vesture, clobber, habit, robe, togs, livery, habilimentation, array, hull, garb, attire, attirement, stitch, rig, garment, raiment, wearable, dressing
醫生	医生	yīshēng	Galen, MD, physician, Dr., medic, doc, hakeem, medico, Aesculapius, medical man, surgeon, leech, doctor
醫院	医院	yīyuàn	spital, hospital, infirmary, hospice
一半	一半	yíbàn	det.: one half, in part, half
一會兒	一会儿	yīhuìr	a moment, a while, in a moment, now...now..., also pr. [yi1 hui3 r5]
一塊兒	一块儿	yīkuàiēr	together
一下兒	一下儿	yīxià r	(used after a verb) give it a go, to do (sth for a bit to give it a try), one time, once, in a while, all of a sudden, all at once, erhua variant of 一下[yi1 xia4]
一樣	一样	yīyàng	same, equal, similar
一邊	一边	yībiān	at the same time, simultaneously;on the one/other hand
一點兒	一点儿	yīdiǎnēr	det.: a little bit
一起	一起	yīqǐ	in chorus, together, in all, in the same place, holus-bolus, altogether, in company
一些	一些	yīxiē	det.: some, a few, a little
用	用	yòng	with, to use, to employ, to have to, to eat or drink, expense or outlay, usefulness, therefore
有	有	yǒu	have, possess, there is, to exist
有的	有的	yǒude	det : some
有名	有名	yǒumíng	well-known, famous
有時候	有时候	yǒushíhòu	from time to time, on occasion, occasionally, somewhile, otherwhile, now and again, sometimes, now and then, at times, on occasion, whiles, once in a while
有些	有些	yǒuxiē	kind of, rather, somewhat
有用	有用	yǒuyòng	belong, profit, count, useful, avail, powerful
右	右	yòu	right side as side of precedence, right side, west, winger, right, the right side, the Right, the right, west (old)
右邊	右边	yoù bian	right side, right, to the right
雨	雨	yǔ	rain
元	元	yuán	m.[standard], currency unit (esp. Chinese yuan), first, primary, fundamental, era (of a reign), (math.) argument, variable, (Tw) (geology) eon
遠	远	yuǎn	far, distant (lit./fig.), remote, (intensifier in a comparison) by far, much (lower etc)
月	月	yuè	moon, monthly, CL:個|个, 輪|轮[lún]
再	再	zài	again, once more, further(more), in a higher degree, and then, not (do sth.) before, second, then (after sth, and not until then), no matter how ... (followed by an adjective or verb, and then (usually) 也[yě] or 都[dōu] for emphasis)
再見	再见	zàijiàn	good-bye, see you again
在	在	zài	in, at, on, etc., (located) at, (to be) in, in the middle of doing sth, (indicating an action in progress)
在傢	在家	zàijiā	At home
早	早	zǎo	early, long ago, in advance, beforehand, prematurely, morning
早飯	早饭	zǎo fàn	breakfast, CL:份[fen4], 頓|顿[dun4], 次[ci4], 餐[can1]
早上	早上	zǎo shang	early morning, CL:個|个[ge4]
怎麼	怎么	zěnme	how
站	站	zhàn	to stand, branch of a company or organization, website
找	找	zhǎo	look for, seek, call on, approach, to try to find, to give change
找到	找到	zhǎodào	light upon, find, discover, run down, founded, regain, strike, come upon, come across, run down, trace, turn up, happen upon, get, chance on, chance upon
這	这	zhè	now, this, det.: this, it, (commonly pr. [zhèi] before a classifier, esp. in Beijing)
這邊	这边	zhèbiān	this side, here
這裡	这里	zhèlǐ	this place, there, here
這兒	这儿	zhèēr	now, here
這些	这些	zhèxiē	det.: these
著	着	zhe	[aspect], aspect particle indicating action in progress
真	真	zhēn	really, truly, indeed, clearly, genuine
真的	真的	zhēnde	really, truly, indeed
正	正	zhèng	precisely, punctually, straight, proper, main, to correct, just (at that time), (math.) positive
正在	正在	zhèngzài	course of, be, be in process
知道	知道	zhīdào	tell, have, ken, understand, infer, wis, learn, cognize, gather, know, be aware of, wise up, savvy, mind, realize
知識	知识	zhīshì	lear, know-how, understanding, ken, instruction, science, sophistication, consciousness, light, awareness, cognizance, knowledge, lore, mastery, know, cognition, acquaintanceship, mind, intellect, knowingness, equipment
中	中	zhōng	center, middle, interior, within, among, while (doing sth), (dialect) OK
中國	中国	zhōngguó	Cathay, China, china
中間	中间	zhōngjiān	center, middle
中文	中文	zhōngwén	Chinese, Ch. (written) language, Ch. language, Sinitic
中午	中午	zhōng wǔ	noon, midday, CL:個|个[ge4]
中學	中学	zhōngxué	middle school, grammar school, secondary school, Ch. learning, middle school, high school, grammar school
中學生	中学生	zhōng xué shēng	middle-school student, high school student
重	重	zhòng	heavy, weighty, important, considerable in amount/value, to attach importance to
重要	重要	zhòngyào	important, significant, major
住	住	zhù	inhabit, cease, stay, visit, shack, dwell, stop, people, live, reside, populate, dig, (suffix indicating firmness, steadiness, or coming to a halt)
準備	准备	zhǔnbèi	prepare, get ready
桌子	桌子	zhuōzi5	mahogany, table, desk
字	字	zì	graphic symbol, writing, pronunciation (of a word), form of a written character, receipt, printing type, script, name taken at the age of 20, courtesy name, wordage, character, grapheme, contract, scripts, symbolic representation, style of handwriting, word, courtesy or style name traditionally given to males aged 20 in dynastic China, CL:個|个[gè]
子	子	zǐ	son, child, seed, egg, small thing, 1st earthly branch: 11 p.m.-1 a.m., midnight, 11th solar month (7th December to 5th January), year of the Rat, Viscount, fourth of five orders of nobility 五等爵位[wu3 deng3 jue2 wei4], ancient Chinese compass point: 0° (north), (noun suffix)
走	走	zǒu	scram, travel, foot, go away, evaporate, ankle, waltz, step, bugger off, etc., go through, leave, leak, run, buzz off, leg, pad, fork, visit, go, escape, lose flavor, work, call on, strike, sashay, trace, pursue, gang, lose shape/etc., get along, come along, walk, hoof it, lose flavor/shape/etc., leg it, let out, shape, drive, cover, take, get, hoof, move, to move (of vehicle), away (in compound verbs, such as 撤走[chè zǒu]), to change (shape, form, meaning)
走路	走路	zǒulù	go away, stroam, go on foot, walk
最	最	zuì	most, to the highest degree, much, superlatively, -est (superlative suffix)
最好	最好	zuìhǎo	had better, it would be best
最後	最后	zuì hoù	final, last, finally, ultimate
昨天	昨天	zuó tiān	yesterday
左	左	zuǒ	left side, east, the Left, the Left (politics), unorthodox, queer, wrong, differing, opposite, variant of 佐[zuǒ]
左邊	左边	zuǒ bian	left, the left side, to the left of
坐	坐	zuò	sit, take seat, to take (a bus, airplane etc), variant of 座[zuò]
坐下	坐下	zuòxià	subside, sit, sit down, sink, sit down
做	做	zuò	make, do, to do, to produce, to act as, to engage in, to hold (a party), to function (in some capacity), to be used for, to form (a bond or relationship)
