他说他会来的，果然来了。	tā shuō tā huì lái de guǒrán lái le	He said he would come, and sure enough he did.	2
你喜欢我的家常菜吗？	nǐ xǐhuan wǒ de jiāchángcài ma	Did you enjoy my home cooking?	2
在来点马铃薯泥好吗？	zài lái diǎn mǎlíngshǔní hǎo ma	Would you like more mashed potato?	2
我无论如何是会去的。	wǒ wúlùnrúhé shì huì qù de	I will go whether or no.	2
他是个自私自利的人。	tā shì gè zìsīzìlì de rén	He is a lump of selfishness.	2
我没心情和你聊天。	wǒ méi xīnqíng hé nǐ liáotiān	I am in no mood for chatting with you.	2
我喜欢她眼睛的光彩。	wǒ xǐhuan tā yǎnjing de guāngcǎi	I like the sparkles in her eyes.	2
他要我问候你。	tā yào wǒ wènhòu nǐ	He asked me to inquire after you.	2
我乐意和你去。	wǒ lèyì hé nǐ qù	I am willing to go with you.	2
我确实得走了。	wǒ quèshí dé zǒu le	I really have to be going.	2
今天有多少学生缺席？	jīntiān yǒu duōshao xuésheng quēxí	How many students are absent today?	2
想吃梨吗？	xiǎng chī lí ma	Would you like a pear?	2
好像要下雨了。	hǎoxiàng yào xiàyǔ le	It looks as if it is going to rain.	2
我相信你是有见识的人。	wǒ xiāngxìn nǐ shì yǒu jiànshi de rén	I give you credit for more sense.	2
她坚决不来。	tā jiānjué bù lái	She was quite adamant that she would not come.	2
他昨天到达的。	tā zuótiān dàodá de	He arrived yesterday.	2
你只要一看见她的脸就会明白，她是无辜的。	nǐ zhǐyào yī kànjiàn tā de liǎn jiù huì míngbai tā shì wúgū de	A glimpse of her face will tell you that she is innocent.	2
谁都不喜欢被人怠慢。	shéi dōu bù xǐhuan bèi rén dàimàn	No one like to be treated with neglect.	2
我钱很宽裕，能帮助她。	wǒ qián hěn kuānyù néng bāngzhù tā	As I had plenty of money I was able to help her.	2
她单独去是很危险的。	tā dāndú qù shì hěn wēixiǎn de	It’s unsafe for her to go alone.	2
他姐姐过去一直指导他，给他出主意，是他的朋友。	tā jiějie guòqu yīzhí zhǐdǎo tā gěi tā chū zhǔyi shì tā de péngyou	His elder sister had been his guide, counsellor and friend.	2
他没注意到她的赞美。	tā méi zhùyì dào tā de zànměi	He does not pay attention her praising.	2
我可以证明她是诚实的。	wǒ kěyǐ zhèngmíng tā shì chéngshí de	I can certify to her honesty.	2
老师对他的学生非常严格。	lǎoshī duì tā de xuésheng fēicháng yángé	The teacher is very strict with his students.	2
你一定是在开玩笑吧。	nǐ yīdìng shì zài kāiwánxiào ba	You must be joking.	2
我不太明白，你能再解释一下吗？	wǒ bù tài míngbai nǐ néng zài jiěshì yīxià ma	I didn’t quite follow; could you explain it again?	2
这对我太合适了。	zhè duì wǒ tài héshì le	Suits me fine.	2
再见了，很高兴见到你。	zàijiàn le hěn gāoxìng jiàndào nǐ	Good-bye. Nice seeing you.	2
他哄她同意带她去看电影。	tā hǒng tā tóngyì dài tā qù kàn diànyǐng	He coaxed her into letting him take her to the cinema.	2
她和他的感受相同。	tā hé tā de gǎnshòu xiāngtóng	She felt just the same as he did.	2
你愿意当你弟弟的保证人吗？	nǐ yuànyì dāng nǐ dìdi de bǎozhèngrén ma	Are you willing to stand surety for your brother?	2
那可简化了我的工作。	nà kě jiǎnhuà le wǒ de gōngzuò	That will simplify my task.	2
他告诉我的消息是真实的。	tā gàosu wǒ de xiāoxi shì zhēnshí de	The news he told me is truthful.	2
请把菜单给我。	qǐng bǎ càidān gěi wǒ	Please show me the menu.	2
我们试图让她和她的家庭和好。	wǒmen shìtú ràng tā hé tā de jiātíng héhǎo	We tried to reconcile her with her family.	2
你周末计划做什么？	nǐ zhōumò jìhuà zuò shénme	What are your plans for the weekend?	2
如果天气好，当然可以。	rúguǒ tiānqì hǎo dāngrán kěyǐ	Certainly, if the weather is fine.	2
她的故事使我很感动。	tā de gùshi shǐ wǒ hěn gǎndòng	I was very moved by her story.	2
我不知道他是否愿意来。	wǒ bù zhīdào tā shìfǒu yuànyì lái	I don’t know whether he is willing to come.	2
要是我知道他的地址就好了。	yàoshi wǒ zhīdào tā de dìzhǐ jiù hǎole	I wish I knew his address.	2
他在面条里放了些醋。	tā zài miàntiáo lǐ fàng le xiē cù	He put some vinegar in the noodles.	2
她在铝锅里下了些面条。	tā zài lǚ guō lǐ xià le xiē miàntiáo	She put some noodles in the aluminum saucepan.	2
只要我身体好一定来。	zhǐyào wǒ shēntǐ hǎo yīdìng lái	I will come provided that I am well enough.	2
医生一会儿就到。	yīshēng yīhuìr jiù dào	The doctor will be here presently.	2
他总是称赞他的女儿。	tā zǒngshì chēngzàn tā de nǚ’ér	He always speaks well of his daughter.	2
我记得很清楚。	wǒ jìde hěn qīngchu	I remember quite clearly.	2
你愿意帮忙吗？	nǐ yuànyì bāngmáng ma	Are you willing to help?	2
这杯子碎了。	zhè bēizi suì le	The glass shattered.	2
他的工作是做国内贸易。	tā de gōngzuò shì zuò guónèi màoyì	He worked in internal trade.	2
欢迎你随时到我们家。	huānyíng nǐ suíshí dào wǒmen jiā	You are always welcome to our house.	2
他的工作符合了我们的期望。	tā de gōngzuò fúhé le wǒmen de qīwàng	His work comes up to what we expect of him.	2
我正准备打电话给你。	wǒ zhèng zhǔnbèi dǎdiànhuà gěi nǐ	I was just about to call you.	2
让我为你的健康干杯。	ràng wǒ wéi nǐ de jiànkāng gānbēi	Let me drink to your health.	2
如果你努力工作，你就会成功。	rúguǒ nǐ nǔlì gōngzuò nǐ jiù huì chénggōng	If you work hard you will succeed.	2
这需要时间。	zhè xūyào shíjiān	It takes time.	2
她穿上袜子。	tā chuānshang wàzi	She draws on her socks.	2
我喜欢他的写作风格，但是不喜欢他的内容。	wǒ xǐhuan tā de xiězuò fēnggé dànshì bù xǐhuan tā de nèiróng	I like the style of his writing but I don’t like the content.	2.083
自从我们在学校认识之后，我们就一直是好朋友。	zìcóng wǒmen zài xuéxiào rènshi zhīhòu wǒmen jiù yīzhí shì hǎopéngyou	We’ve been friends ever since we met at school.	2.083
我的朋友告诉我她住的地方文化生活贫乏。	nà wèi zhíyuán yòng suànpán jiāng shàngzhōu de huāxiāo jìsuàn chūlái	My friend told me that the place she live is a cultural wasteland.	2.083
我清楚地告诉他，我拒绝了他的建议。	wǒ qīngchu dì gàosu tā wǒ jùjué le tā de jiànyì	I made it clear to him that I rejected his proposal.	2.091
因为天气热，她穿了一件凉快的衣服。	yīnwèi tiānqì rè tā chuān le yī jiàn liángkuai de yīfu	As it was a hot day she wore a cool dress.	2.1
我虽然很喜欢她，却不打算娶她。	wǒ suīrán hěn xǐhuan tā què bù dǎsuàn qǔ tā	Much as I like her, I won’t marry her.	2.1
我证明他已经收到了你的钱。	wǒ zhèngmíng tā yǐjīng shōu dàoliǎo nǐ de qián	I certify that he has received your money.	2.111
你能告诉我你一个月赚多少吗？	nǐ néng gàosu wǒ nǐ yī gè yuè zhuàn duōshao ma	Can you tell me how much you earn a month?	2.111
我过去相信你是有见识的人。	wǒ guòqu xiāngxìn nǐ shì yǒu jiànshi de rén	I gave you credit for more sense.	2.111
在我苦恼的时候，她来安慰我。	zài wǒ kǔnǎo de shíhou tā lái ānwèi wǒ	She comforted me in my distress.	2.111
我有了新工作和一班新同事。	wǒ yǒule xīn gōngzuò hé yī bān xīn tóngshì	I got a new job and a new set of work associations.	2.111
因为现在是收获期，所以我们都非常忙。	yīnwèi xiànzài shì shōuhuò qī suǒyǐ wǒmen dōu fēicháng máng	We are all very busy because it’s the harvest time.	2.111
简单朴素的衣服适合在学校里穿。	jiǎndān pǔsù de yīfu shìhé zài xuéxiào lǐ chuān	Plain, simple clothes are appropriate for school wear.	2.111
啊，我真喜欢这首歌！好高兴！	ā wǒ zhēn xǐhuan zhè shǒugē hǎo gāoxìng	Ah, I really love this song！ I am so glad！	2.125
我就他的小说向他提问。	wǒ jiù tā de xiǎoshuō xiàng tā tíwèn	I plied him with questions about his novel.	2.125
他是个和蔼而快乐的人。	tā shì gè hé’ǎi ér kuàilè de rén	He is a friendly jovial fellow.	2.125
他是世界上最富有的人。	tā shì shìjiè shàng zuì fù yǒude rén	He is the richest man in the world.	2.125
我特地为你做了个蛋糕。	wǒ tèdì wéi nǐ zuò le gè dàngāo	I made a cake specially for you.	2.125
他的失败是再明白不过了。	tā de shībài shì zài míngbai bùguò le	His failure is as plain as plain can be.	2.125
一般人都相信努力是值得的。	yībānrén dōu xiāngxìn nǔlì shì zhíde de	It is generally believed that it pays to work hard.	2.125
她在医院里接受了全面检查。	tā zài yīyuàn lǐ jiēshòu le quánmiàn jiǎnchá	She underwent a thorough examination at the hospital.	2.125
那册书还能买到吗？	nà cè shū hái néng mǎi dào ma	Is that volume still in print?	2.143
我已经写了三个小时了。	wǒ yǐjīng xiě le sān gè xiǎoshí le	I’ve been writing for three hours.	2.143
我的钟一定是坏了。	wǒ de zhōng yīdìng shì huài le	There must be something wrong with my clock.	2.143
这只杯子是不锈钢做的。	zhè zhǐ bēizi shì bùxiùgāng zuò de	This cup is made of stainless steel.	2.143
他的盘子里盛满了米饭。	tā de pánzi lǐ chéng mǎn le mǐfàn	His plate was piled high with rice.	2.143
我不喜欢它因为很吵闹。	wǒ bù xǐhuan tā yīnwèi hěn chǎonào	I didn’t like it because it was noisy.	2.143
这完全是你力所能及的工作。	zhè wánquán shì nǐ lìsuǒnéngjí de gōngzuò	This is a task well within your ability.	2.143
我们在那儿几乎没看见学生。	wǒmen zàinar jīhū méi kànjiàn xuésheng	We saw few students there.	2.143
他的级别比我高。	tā de jíbié bǐ wǒ gāo	He is above me in rank.	2.167
他的物理学得很好。	tā de wùlǐxué dehěn hǎo	He does well in physics.	2.167
她喜欢和我一起溜冰。	tā xǐhuan hé wǒ yīqǐ liūbīng	She likes to ice-skate with me.	2.167
我不喜欢喝速溶咖啡。	wǒ bù xǐhuan hē sùróngkāfēi	I don’t like to drink instant coffee.	2.167
他一再说他很忙。	tā yīzài shuō tā hěn máng	He repeated several times that he was busy.	2.167
她是个真正的专家。	tā shì gè zhēnzhèng de zhuānjiā	She is a real professional.	2.167
这是个棘手的问题。	zhè shì gè jíshǒu de wèntí	It’s a thorny subject.	2.167
我的钢笔是新的。	wǒ de gāngbǐ shì xīn de	My pen is new.	2.167
他的痛苦现在已经过去。	tā de tòngkǔ xiànzài yǐjīng guòqu	His pain is past now.	2.167
这是个神奇的故事。	zhè shì gè shénqí de gùshi	It’s a magical story.	2.167
我不理解她的逻辑。	wǒ bù lǐjiě tā de luóji	I didn’t follow her logic.	2.167
他写的论文很优秀。	tā xiě de lùnwén hěn yōuxiù	The treatise he wrote is excellent.	2.167
他和他哥哥一样英俊。	tā hé tā gēge yīyàng yīngjùn	He is as handsome as his brother (is).	2.167
是的，这事我知道，谢谢。	shìde zhè shì wǒ zhīdào xièxie	Yes, I know that, thanks.	2.167
我是今天早晨从报纸上知道这条消息的。	wǒ shì jīntiān zǎochén cóng bàozhǐ shàng zhīdào zhè tiáo xiāoxi de	I learned this piece of news from the newspaper this morning.	2.167
你的生活目标是什么？	nǐ de shēnghuó mùbiāo shì shénme	What is your aim in life?	2.167
我有一大堆工作要做。	wǒ yǒu yī dà duī gōngzuò yào zuò	I have a mountain of work to do.	2.167
劳驾，能让我过去吗？	láojià néng ràng wǒ guòqu ma	Excuse me, can I get past, please?	2.167
别慌忙，时间多的是。	bié huāngmáng shíjiān duō de shì	Don’t rush; there is plenty of time.	2.167
我们都相信她的预言。	wǒmen dōu xiāngxìn tā de yùyán	We all believed in her prediction.	2.167
我讨厌他在教室抽烟。	wǒ tǎoyàn tā zài jiàoshì chōuyān	I got sick of his smoking in the classroom.	2.167
气候影响了他的健康。	qìhòu yǐngxiǎng le tā de jiànkāng	The climate affected his health.	2.167
我们可以轻松地开始工作。	wǒmen kěyǐ qīngsōng dì kāishǐ gōngzuò	We can set to work with a light heart.	2.167
我们刚才看见的那位同志是你的老师吗？	wǒmen gāngcái kànjiàn de nà wèi tóngzhì shì nǐ de lǎoshī ma	Be the comrade whom we see just now your teacher?	2.182
问题是什么时候能得到我们所需要的钱。	wèntí shì shénmeshíhou néng dédào wǒmen suǒ xūyào de qián	The problem is when to get the money we need.	2.182
他的书对这一问题的论述是最好的，仅次于我的书。	tā de shū duì zhè yī wèntí de lùnshù shì zuìhǎo de jǐncìyú wǒ de shū	His book is the best on the subject after mine.	2.188
她和他订婚了。	tā hé tā dìnghūn le	She plighted herself to him.	2.2
这是谁的钢笔？	zhè shì shéi de gāngbǐ	Whose pen is this?	2.2
我不太喜欢下棋。	wǒ bù tài xǐhuan xiàqí	I’m not very fond of playing chess.	2.2
他是个小机灵鬼。	tā shì gè xiǎo jīlíngguǐ	He is a smart boy.	2.2
我觉得我很空虚。	wǒ juéde wǒ hěn kōngxū	I feel I am in emptiness.	2.2
他的衣服破烂不堪了。	tā de yīfu pòlàn bùkān le	His clothes were torn to rags.	2.2
我妈妈是个家庭妇女。	wǒ māma shì gè jiātíng fùnǚ	My mother is a housewife.	2.2
我喜欢你的幽默感。	wǒ xǐhuan nǐ de yōumògǎn	I like your sense of humor.	2.2
她喜欢随着音乐跳舞。	tā xǐhuan suízhe yīnyuè tiàowǔ	She loves to dance to music.	2.2
听说你的猫死了，我觉得很难过。	tīngshuō nǐ de māo sǐ le wǒ juéde hěn nánguò	I was sorry to hear that your cat had died.	2.2
难怪她病了，她几乎什么都没吃。	nánguài tā bìng le tā jīhū shénme dōu méi chī	No wonder she’s ill. She eats next to nothing.	2.2
你妈妈是个乐呵呵的容易相处的人。	nǐ māma shì gè lèhēhē de róngyì xiāngchǔ de rén	Your mother is a jolly, easy-going woman.	2.2
我相信他是个我们应当尊敬的人。	wǒ xiāngxìn tā shì gè wǒmen yīngdāng zūnjìng de rén	He is a man whom I believe we should respect.	2.2
我肯定你有能力。	wǒ kěndìng nǐ yǒunénglì	I’ve no doubt of your ability.	2.2
他跳上了桌子。	tā tiào shàng le zhuōzi	He jumped onto the table.	2.2
我必须告诉你，他的耐心是有限的。	wǒ bìxū gàosu nǐ tā de nàixīn shì yǒuxiàn de	I must tell you that his patience has its limit.	2.2
我们大家都认为考试作弊是不对的。	wǒmen dàjiā dōu rènwéi kǎoshì zuòbì shì bùduì de	We all consider it wrong to cheat in examinations.	2.2
我们决定立刻去火车站。	wǒmen juédìng lìkè qù huǒchēzhàn	We determined to go to the railway station at once.	2.2
你能告诉我是谁发明了电话？	nǐ néng gàosu wǒ shì shéi fāmíng le diànhuà	Can you tell me who invented the telephone?	2.222
他没有给我回答他问题的机会。	tā méiyǒu gěi wǒ huídá tā wèntí de jīhuì	He gave me no chance to reply to his question.	2.222
这本书是我特意为你买的。	zhè běn shū shì wǒ tèyì wéi nǐ mǎi de	I bought the book especially for you.	2.222
我很不喜欢住在闭塞的乡村。	wǒ hěn bù xǐhuan zhù zài bìsè de xiāngcūn	I hate being shut away in the country.	2.222
我相信礼貌对大家是很重要的。	wǒ xiāngxìn lǐmào duì dàjiā shì hěn zhòngyào de	It is my belief that good manners are very important to everybody.	2.222
我们得给我们的新房子买些家具。	wǒmen dé gěi wǒmen de xīn fángzi mǎi xiē jiājù	We will buy some furniture for our new house.	2.222
他长大了，穿剩下的衣服就给了他的弟弟。	tā zhǎngdà le chuān shèngxià de yīfu jiù gěi le tā de dìdi	As he grew up he passed on his clothes to his younger brother.	2.231
如果我后悔什么事情，那很可能是我的良好品行。	rúguǒ wǒ hòuhuǐ shénme shìqing nà hěn kěnéng shì wǒ de liánghǎo pǐnxíng	If I repent of anything, it is very likely to be my good behaviour.	2.231
我不喜欢吃菠菜，虽然我知道它对我有好处。	wǒ bù xǐhuan chī bōcài suīrán wǒ zhīdào tā duì wǒ yǒuhǎochù	I don’t like spinach even though I know it’s good for me.	2.231
我今天提早工作都做完了，但是别人都还在工作，我不好意思回家。	wǒ jīntiān tízǎo gōngzuò dōu zuòwán le dànshì biéren dōu hái zài gōngzuò wǒ bùhǎoyìsi huíjiā	I have gotten my work all done ahead of time today, but I’d feel guilty going home while everybody else is still work.	2.235
他的想法和我的不一致。	tā de xiǎngfǎ hé wǒ de bù yīzhì	His ideas do not conform to mine.	2.25
他能跑得和我一样快。	tā néng pǎo dé hé wǒ yīyàng kuài	He can run as fast as I can.	2.25
他向我告别。	tā xiàng wǒ gàobié	He has taken leave of me.	2.25
可能的话，她想跟我们一起去。	kěnéng dehuà tā xiǎng gēn wǒmen yīqǐ qù	If possible, She wants to go with us.	2.25
我非常想念你。	wǒ fēicháng xiǎngniàn nǐ	I miss you very much.	2.25
水的密度是1。	shuǐ de mìdù shì	The density of water is 1.	2.25
没人理睬他。	méi rén lǐcǎi tā	Nobody speaks to him.	2.25
我在街道对面的连锁商店里买了这只面包。	wǒ zài jiēdào duìmiàn de liánsuǒshāngdiàn lǐ mǎi le zhè zhǐ miànbāo	I bought this loaf of bread in the chain store opposite the street.	2.25
你应该可怜他。	nǐ yīnggāi kělián tā	You should take pity on him.	2.25
我不喜欢孤独。	wǒ bù xǐhuan gūdú	I am not fond of solitude.	2.25
既然你喜欢我的连衣裙而我也喜欢你的，咱们交换好吗？	jìrán nǐ xǐhuan wǒ de liányīqún ér wǒ yě xǐhuan nǐ de zánmen jiāohuàn hǎo ma	As you like my dress and I like yours, shall we do a swap?	2.25
请你为我翻译一下好吗？	qǐng nǐ wéi wǒ fānyì yīxià hǎo ma	Would you please interpret for me?	2.25
她的热心感动了所有的人。	tā de rèxīn gǎndòng le suǒyǒu de rén	Her eagerness moved all the people.	2.25
她不应该把我的信公开。	tā bù yīnggāi bǎ wǒ de xìn gōngkāi	She should not give publicity to my letter.	2.25
你知道是谁发明的指南针吗？	nǐ zhīdào shì shéi fāmíng de zhǐnánzhēn ma	Do you know who invents the compass?	2.25
我和她商量过我的报告。	wǒ hé tā shāngliang guò wǒ de bàogào	I consulted with her about my report.	2.25
他不提他曾经和她见面。	tā bù tí tā céngjīng hé tā jiànmiàn	He made no mention of having met her.	2.25
别让我失望。	bié ràng wǒ shīwàng	Don’t let me down.	2.25
真让我失望。	zhēn ràng wǒ shīwàng	I’m very disappointed.	2.25
他的痛苦引起了我们的同情。	tā de tòngkǔ yǐnqǐ le wǒmen de tóngqíng	His sufferings aroused our sympathy.	2.25
我还认识到了集体的力量。	wǒ hái rènshi dàoliǎo jítǐ de lìliang	I also learned the strength of the collective.	2.25
她用蔑视的态度和我们说话。	tā yòng mièshì de tàidu hé wǒmen shuōhuà	She talked to us with a defiant manner.	2.25
我感觉不舒服。	wǒ gǎnjué bùshūfu	I’m not feeling well.	2.25
他在食槽里放了些草。	tā zài shícáo lǐ fàng le xiē cǎo	He put some grass in the manger.	2.25
我们的经理对我们要求很严格。	wǒmen de jīnglǐ duì wǒmen yāoqiú hěn yángé	Our manager is very strict with us.	2.25
我不会把我的钱投资到他的公司。	wǒ bùhuì bǎ wǒ de qián tóuzī dào tā de gōngsī	I won’t invest my money in his company.	2.273
我可以从她的眼睛里看出她的喜悦。	wǒ kěyǐ cóng tā de yǎnjing lǐ kànchū tā de xǐyuè	I can see her gladness in her eyes.	2.273
她所有的钱都投放到股票里去了。	tā suǒyǒu de qián dōu tóufàng dào gǔpiào lǐ qù le	She’s got all her money in stocks and shares.	2.273
我想请你下星期日去参加舞会好吗？	wǒ xiǎng qǐng nǐ xià Xīngqīrì qù cānjiā wǔhuì hǎo ma	I would like to invite you to a ball next Sunday.	2.273
我只关心我觉得对我很重要的事物。	wǒ zhǐ guānxīn wǒ juéde duì wǒ hěn zhòngyào de shìwù	I am concerned only with things that I feel are important to me.	2.273
我女儿喜欢给我讲她那些奇怪的梦。	wǒ nǚ’ér xǐhuan gěi wǒ jiǎng tā nàxiē qíguài de mèng	My daughter likes to describe her fantastic dreams to me.	2.273
请把账单给我好吗？	qǐng bǎ zhàngdān gěi wǒ hǎo ma	Could I have the bill, please?	2.286
他解除了和她的婚姻。	tā jiě chúle hé tā de hūnyīn	He obtained the dissolution of his marriage with her.	2.286
秋季是我最喜欢的季节。	qiūjì shì wǒ zuì xǐhuan de jìjié	Autumn is my favourite season.	2.286
刚才你男朋友给你打电话了。	gāngcái nǐ nánpéngyou gěi nǐ dǎdiànhuà le	Your boyfriend called you just now.	2.286
一小时之内我就会到。	yī xiǎoshí zhīnèi wǒ jiù huì dào	I’ll be coming within an hour.	2.286
她讲了她的冒险经历。	tā jiǎng le tā de màoxiǎn jīnglì	She recounted her adventures.	2.286
你完全误解了我的意思。	nǐ wánquán wùjiě le wǒ de yìsi	You mistook my meaning entirely.	2.286
她委托邻居照顾她的孩子。	tā wěituō línjū zhàogu tā de háizi	She resigned her children to the care of a neighbor.	2.286
那就说明了她不在这里的原因。	nà jiù shuōmíng le tā bùzài zhèlǐ de yuányīn	That explains why she is not here.	2.3
我津津有味地品尝了我妈妈做的鱼。	wǒ jīnjīnyǒuwèi dì pǐncháng le wǒ māma zuò de yú	I tasted the fish my mother cooked with relish.	2.3
我们给她些压力她就会讲出来。	wǒmen gěi tā xiē yālì tā jiù huì jiǎng chūlái	She’ll sing if we put the pressure on.	2.3
我三番五次请她来，她都断然拒绝了。	wǒ sānfānwǔcì qǐng tā lái tā dōu duànrán jùjué le	I asked her several times to come but she categorically refused.	2.333
他的钱是我的三倍还不止。	tā de qián shì wǒ de sānbèi hái bùzhǐ	He has more than three times my money.	2.333
再给你倒杯茶好吗？	zài gěi nǐ dǎo bēi chá hǎo ma	Can I pour you another cup of tea?	2.333
我确信你是对的。	wǒ quèxìn nǐ shì duì de	I’m sure you’re right.	2.333
让她走，别阻拦她。	ràng tā zǒu bié zǔlán tā	Let her go. Don’t stop her.	2.333
这是他的亲笔画。	zhè shì tā de qīn bǐhuà	This is a picture of his own painting.	2.333
我亲眼看见他拿了钱。	wǒ qīnyǎn kànjiàn tā ná le qián	I personally see him taking money.	2.333
要我承认错了，是很费力的。	yào wǒ chéngrèn cuò le shì hěn fèilì de	It was painful to admit that I was wrong.	2.333
我想帮忙你捆扎东西。	wǒ xiǎng bāngmáng nǐ kǔn zhā dōngxi	I would like to help you pack.	2.333
我原谅了他的过失。	wǒ yuánliàng le tā de guòshī	I looked over his faults.	2.333
太糟糕了。	tài zāogāo le	That’s too bad.	2.333
你知道怎么挤牛奶吗？	nǐ zhīdào zěnme jǐ niúnǎi ma	Do you know how to milk a cow?	2.333
我喜欢滑冰。	wǒ xǐhuan huábīng	I like skating.	2.333
我对他很生气，因为他让我等了好久。	wǒ duì tā hěn shēngqì yīnwèi tā ràng wǒděng le hǎojiǔ	I was angry with him for keeping me waiting.	2.333
我妈妈鼓励我，而且坚持我应该继续我的教育。	wǒ māma gǔlì wǒ érqiě jiānchí wǒ yīnggāi jìxù wǒ de jiàoyù	My mother encouraged me and insisted that I continue my education.	2.333
他将他的名字写在清单上。	tā jiāng tā de míngzi xiě zài qīngdān shàng	He wrote down his name on the list.	2.333
我希望他别再招待他的朋友了。	wǒ xīwàng tā bié zài zhāodài tā de péngyou le	I wish he would desist from entertaining his friends.	2.333
我最喜欢吃桔子，其次才是香蕉。	wǒ zuì xǐhuan chī júzi qícì	Next to orange I like banana best.	2.333
不休息我们就走不动了。	bù xiūxi wǒmen jiù zǒu bùdòng le	We can’t go any farther without a rest.	2.333
他的粗鲁让我生气。	tā de cūlǔ ràng wǒ shēngqì	His rudeness made me really angry.	2.333
他身体在逐步好起来。	tā shēntǐ zài zhúbù hǎoqǐlai	He is getting better by degrees.	2.333
现在请注意它的商标。	xiànzài qǐng zhùyì tā de shāngbiāo	Now pay attention its brand please.	2.333
我们喜欢看海豚的表演。	wǒmen xǐhuan kàn hǎitún de biǎoyǎn	We like to see the performance of dolphins.	2.333
如果我需要你来帮忙，我会打电话的。	rúguǒ wǒ xūyào nǐ lái bāngmáng wǒ huì dǎdiànhuà de	If I need you to come and help I’ll call.	2.333
她对新环境不习惯。	tā duì xīn huánjìng bù xíguàn	She is not used to the new environment.	2.333
他说话谨慎。	tā shuōhuà jǐnshèn	He is careful in his speech.	2.333
全部艰苦的工作都是我做的，但是我的老板却宣布那是他自己的发现，窃取了我的发明创造。	quánbù jiānkǔ de gōngzuò dōu shì wǒ zuò de dànshì wǒ de lǎobǎn què xuānbù nàshi tā zìjǐ de fāxiàn qièqǔ le wǒ de fāmíngchuàngzào	I did all the hard work but my boss stole my thunder by announcing the discovery as his own	2.346
那把椅子原本是为你准备的，但是被她拿走了。	nà bǎ yǐzi yuánběn shì wéi nǐ zhǔnbèi de dànshì bèi tā názǒu le	The chair was intended for you, but she took it away.	2.357
这只猫毛很光滑，看来喂得很好。	zhè zhǐ māo máo hěn guānghuá kànlai wèi dehěn hǎo	The cat looked very sleek and well fed.	2.364
这是我买过的最奢侈的东西。	zhè shì wǒ mǎi guò de zuì shēchǐ de dōngxi	It was the most extravagant purchase I have ever made.	2.364
我给他这一机会，他立刻抓住不放。	wǒ gěi tā zhè yī jīhuì tā lìkè zhuāzhù bù fàng	When I gave him the chance, he grabbed it at once.	2.364
我还能有别的方法可以向她道歉吗？	wǒ hái néng yǒu biéde fāngfǎ kěyǐ xiàng tā dàoqiàn ma	How else can I apologize for her?	2.364
现在我不会唱歌了，但我年轻的时候会。	xiànzài wǒ bùhuì chànggē le dàn wǒ niánqīng de shíhou huì	I can’t sing now, but I could when I was young.	2.364
他的妻子知道在他生气时怎么对付他。	tā de qīzi zhīdào zài tā shēngqì shí zěnme duìfu tā	His wife knows how to manage him when he is angry.	2.364
我没有注意到他已经走了。	wǒ méiyǒu zhùyì dào tā yǐjīng zǒu le	I failed to note that he had left.	2.375
我喜欢唱歌，更不用说听音乐了。	wǒ xǐhuan chànggē gèng bùyòng shuō tīng yīnyuè le	I enjoy singing, much more listening to music.	2.375
他的作文比我的好多了。	tā de zuòwén bǐ wǒ de hǎoduō le	His composition is far superior to mine.	2.375
我把赚的钱都花光了。	wǒ bǎ zhuàn de qián dōu huāguāng le	I’ve spent all my earnings.	2.375
我与这外宾的关系很好。	wǒ yǔ zhè wàibīn de guānxi hěn hǎo	I am on good terms with this foreign friend.	2.375
我想我能来，但还说不定。	wǒ xiǎng wǒ néng lái dàn hái shuōbudìng	I think I can come, but don’t rely on it.	2.375
发现她在那，我感到很吃惊。	fāxiàn tā zài nà wǒ gǎndào hěn chījīng	I was amazed to find her there.	2.375
我想我们能从中学到许多。	wǒ xiǎng wǒmen néng cóng zhōngxué dào xǔduō	I think we may learn much from it.	2.375
我把这消息传达给他了。	wǒ bǎ zhè xiāoxi chuándá gěi tā le	I conveyed the information to him.	2.375
他是个坚强而沉默的人。	tā shì gè jiānqiáng ér chénmò de rén	He is the strong, silent type.	2.375
我知道他们和你在议论我。	wǒ zhīdào tāmen hé nǐ zài yìlùn wǒ	I know they have been discussing me with you.	2.375
他让他的马退出了比赛。	tā ràng tā de mǎ tuìchū le bǐsài	He withdrew his horse from the race.	2.375
在空白栏中写上你的名字。	zài kòngbái lán zhōng xiě shàng nǐ de míngzi	Write your name in the blank.	2.375
所有的植物都需要水和阳光。	suǒyǒu de zhíwù dōu xūyào shuǐ hé yángguāng	All plants need water and light.	2.375
他的拒绝浇熄了我们的热情。	tā de jùjué jiāo xī le wǒmen de rèqíng	His refusal iced our enthusiasm.	2.375
我很荣幸能介绍我们的州长	wǒ hěn róngxìng néng jièshào wǒmen de zhōuzhǎng	I have the honor to present the governor.	2.375
老实讲，我不同意你的计划。	lǎoshi jiǎng wǒ bùtóng yì nǐ de jìhuà	To tell the truth, I don’t agree to your plan.	2.375
你在我抽屉里乱翻什么？	nǐ zài wǒ chōuti lǐ luàn fān shénme	What are you burrowing around in my drawer for?	2.375
他正在尽力弄明白他的意思。	tā zhèngzài jìnlì nòngmíngbai tā de yìsi	He is trying his best to understand his meaning.	2.375
我想北极地区的人要比这里的少得多。	wǒ xiǎng běijí dìqū de rén yào bǐ zhèlǐ de shǎo dé duō	I guess there are much less people in the Arctic regions than here.	2.385
你要是到商店去，可以给我捎些香烟来吗？	nǐ yàoshi dào shāngdiàn qù kěyǐ gěi wǒ shāo xiē xiāngyān lái ma	If you’re going to the shops, could you bring me back some cigarettes?	2.385
你太粗心了，居然连你妈妈的生日也忘了。	nǐ tài cūxīn le jūrán lián nǐ māma de shēngrì yě wàng le	It was thoughtless of you to forget your mother’s birthday.	2.385
他对他的母亲的敬爱给了我深刻的印象。	tā duì tā de mǔqīn de jìng’ài gěi le wǒ shēnkè de yìnxiàng	He pressed me profound in his respecting and loving to his mother.	2.385
我已经把我所有的希望都寄托在你身上了。	wǒ yǐjīng bǎ wǒ suǒyǒu de xīwàng dōu jìtuō zài nǐ shēnshang le	I have staked all my hopes on you.	2.385
根据我们的记录，你借的书现在应该还给图书馆了。	gēnjù wǒmen de jìlù nǐ jiè de shū xiànzài yīnggāi huángěi túshūguǎn le	According to our records, the books you have borrowed should now be returned to the library.	2.385
他比我大两岁。	tā bǐ wǒ dà liǎng suì	He is my senior by two years.	2.4
我正在要告辞了。	wǒ zhèngzài yào gàocí le	I am going to leave now.	2.4
我经常带我的孩子们去公园玩。	wǒ jīngcháng dài wǒ de háizimen qù gōngyuán wán	I often take my children to play in the park.	2.4
我非常喜欢吃冰淇淋。	wǒ fēicháng xǐhuan chī bīngqílín	I am very fond of icecream.	2.4
他每次度假都会带他的狗去。	tā měicì dùjià dūhuì dài tā de gǒu qù	He never goes on a vacation but he takes his pet dog.	2.4
他向我提了一些很好的意见。	tā xiàng wǒ tí le yīxiē hěn hǎo de yìjiàn	He gave me some good advice.	2.4
她讨厌他到不和他讲话的程度。	tā tǎoyàn tā dào bùhé tā jiǎnghuà de chéngdù	She hates him to the point of not talking to him.	2.4
我认为她是个很能干的经理。	wǒ rènwéi tā shì gè hěn nénggàn de jīnglǐ	I summed her up as a competent manager.	2.4
你真让我恶心！	nǐ zhēn ràng wǒ ěxīn	You make me sick！	2.4
现在的时装和我还是小女孩时候流行的样子很不一样了。	xiànzài de shízhuāng hé wǒ háishi xiǎo nǚhái shíhou liúxíng de yàngzi hěn bùyīyàng le	Fashions have changed a lot since I was a little girl.	2.4
她在最不合适的时候讲出了实话。	tā zài zuì bùhéshì de shíhou jiǎng chū le shíhuà	She plumped out the truth at the oddest times.	2.4
她真心真意的帮助我。	tā zhēnxīn zhēnyì de bāngzhù wǒ	She helps me with heartfelt feeling.	2.4
我们去吃冰淇淋吧。	wǒmen qù chī bīngqílín ba	Let’s go for an ice cream.	2.4
他的热情给公司注入了新的生命。	tā de rèqíng gěi gōngsī zhùrù le xīn de shēngmìng	His enthusiasm breathed new life into the company.	2.4
他想扩充自己在这一行业的知识。	tā xiǎng kuòchōng zìjǐ zài zhè yī hángyè de zhīshi	He wants to widen his knowledge of the industry.	2.4
我非常为你惋惜。	wǒ fēicháng wéi nǐ wǎnxī	I’m dreadfully sorry for you.	2.4
我明天晚上来。	wǒ míngtiān wǎnshang lái	I’ll come round tomorrow evening.	2.4
我珍惜你的友谊。	wǒ zhēnxī nǐ de yǒuyì	I treasure your friendship.	2.4
我恳求你告诉我。	wǒ kěnqiú nǐ gàosu wǒ	I beseech you to tell me.	2.4
谢谢你给我们送礼物。	xièxie nǐ gěi wǒmen sòng lǐwù	Thank you for the present.	2.4
我正在找兼职工作。	wǒ zhèngzài zhǎo jiānzhí gōngzuò	I’m looking for a part-time job.	2.4
我看到他就高兴。	wǒ kàn dào tā jiù gāoxìng	I never see him but I am happy.	2.4
让我猜一猜。	tài zāogāo le	Let me guess.	2.4
这星期他会很忙。	zhè xīngqī tā huì hěn máng	He is very busy this week.	2.4
冬天的时候，我们不得不穿上温暖的衣服。	dōngtiān de shíhou wǒmen bùdébù chuānshang wēnnuǎn de yīfu	We have to put on warm clothing in winter.	2.4
我及时参加了会议。	wǒ jíshí cānjiā le huìyì	I went to attend the meeting betimes.	2.4
我必须立刻开始工作。	wǒ bìxū lìkè kāishǐ gōngzuò	I must start working at once.	2.4
他十岁的时候就已经长得比他哥哥高了。	tā shí suì de shíhou jiù yǐjīng zhǎngde bǐ tā gēge gāo le	By the time he is ten, he has outgrown his older brother.	2.417
我不喜欢他，但是说句公道话，他是个好工人。	wǒ bù xǐhuan tā dànshì shuō jù gōngdào huà tā shì gè hǎo gōngrén	I don’t like him, but, to give him his due, he is a good worker.	2.417
我觉得这是个合理的建议，但他不同意。	wǒ juéde zhè shì gè hélǐ de jiànyì dàn tā bùtóng yì	I thought it was a reasonable proposal, but he didn’t agree.	2.417
不跟你父亲打个招呼就走是非常不合适的。	bù gēn nǐ fùqīn dǎ gè zhāohu jiù zǒu shì fēicháng bùhéshì de	To go away without telling your father is most irregular.	2.417
书和我的关系正如同水和植物的关系。	shū hé wǒ de guānxi zhèng rútóng shuǐ hé zhíwù de guānxi	As water is to the plant, so are books to me.	2.417
她女儿的漂亮眼睛是来自她的部分遗传特征。	tā nǚ’ér de piàoliang yǎnjing shì láizì tā de bùfen yíchuán tèzhēng	Her daughter’s bonny eyes are parts of her heredity.	2.417
因为我的愚蠢，我不得不站起来听他的批评。	yīnwèi wǒ de yúchǔn wǒ bùdébù zhànqǐlai tīng tā de pīpíng	I have to stand up listening to his criticism of my foolishness.	2.417
她是个有声望的专家。	tā shì gè yǒu shēngwàng de zhuānjiā	She is a reputable expert.	2.429
我喜欢和我的家人沟通。	wǒ xǐhuan hé wǒ de jiārén gōutōng	I like to communicate with my family.	2.429
我喜欢吃有黄瓜的三明治。	tā láidào Běijīng xiǎng pèng pèngyùnqi	I like to eat cucumber sandwiches.	2.429
他的中国功夫是无敌的。	tā de Zhōngguó gōngfu shì wúdí de	His Chinese kung fu is peerless.	2.429
北京是中国的政治和金融中心。	Běijīng shì Zhōngguó de zhèngzhì hé jīnróng zhōngxīn	Beijing is the political and financial center of China.	2.429
你能扶我上楼梯吗？	nǐ néng fú wǒ shàng lóutī ma	Could you help me up the stairs?	2.429
我们正向家的方向走去。	wǒmen zhèng xiàng jiāde fāngxiàng zǒuqù	We are heading home.	2.429
那块骨头上没多少肉。	nà kuài gǔtou shàng méi duōshao ròu	There’s not much meat on that bone.	2.429
这事你本可以提醒我的。	zhè shì nǐ běn kěyǐ tíxǐng wǒ de	You might’ve reminded me of that.	2.429
他和他的大哥一样聪明。	tā hé tā de dàgē yīyàng cōngming	He is no less clever than his elder brother.	2.429
不开心是他生病的根源。	bù kāixīn shì tā shēngbìng de gēnyuán	Unhappiness is the root cause of his illness.	2.429
他对他的决定很坚定。	tā duì tā de juédìng hěn jiāndìng	He is unmoved in his decision.	2.429
她努力要实现她的理想。	tā nǔlì yào shíxiàn tā de lǐxiǎng	She tries up to live up to her ideals.	2.429
我对他并不了解，虽然我认识他已经很长时间了。	wǒ duì tā bìngbù liǎojiě suīrán wǒ rènshi tā yǐjīng hěn cháng shíjiān le	I don’t know him well though I’ve known him for a long time.	2.429
我离开巴黎已经两星期了。	wǒ líkāi Bālí yǐjīng liǎngxīngqī le	I have been away from Paris for two weeks.	2.429
我非常尊重他的工作。	wǒ fēicháng zūnzhòng tā de gōngzuò	I esteem his work highly.	2.429
每个母亲都爱她的孩子。	měi gè mǔqīn dōu ài tā de háizi	Every mother has affection for her children.	2.429
我一直期待着和您见面。	wǒ yīzhí qīdài zhe hé nín jiànmiàn	I have been looking forward to seeing you.	2.429
她的智慧比我们猜想的要高。	tā de zhìhuì bǐ wǒmen cāixiǎng de yào gāo	She has more intelligence than we suspected her to possess.	2.444
她的马车是院子里最漂亮的。	tā de mǎchē shì yuànzi lǐ zuì piàoliang de	Her carriage was the most beautiful one in the yard.	2.444
我对他的功劳评价不很高。	wǒ duì tā de gōngláo píngjià bùhěn gāo	I don’t rate his merits very high.	2.444
玛丽所有的钱是怎么赚到的？	Mǎlì suǒyǒu de qián shì zěnme zhuàn dào de	How did Mary make all of her money?	2.444
中国菜在每一方面都是精美的。	Zhōngguócài zài měi yīfāngmiàn dōu shì jīng Měidí	Everything about Chinese food is refined.	2.444
那是个复杂得无法解决的问题。	nàshi gè fùzá dé wúfǎ jiějué de wèntí	It’s a problem of such perplexity that it was impossible to solve.	2.444
她父亲永不会同意她和你结婚。	tā fùqīn yǒng bùhuì tóngyì tā hé nǐ jiéhūn	Her father will never approve of her marriage to you.	2.444
他在自己的领域里已经出名了。	tā zài zìjǐ de lǐngyù lǐ yǐjīng chūmíng le	He has become famous in his own field.	2.444
她的心思完全集中在工作上了。	tā de xīnsi wánquán jízhōng zài gōngzuò shàng le	She was completely absorbed in her task [work].	2.444
我们很高兴，我们的足球队获得了胜利。	wǒmen hěn gāoxìng wǒmen de zúqiúduì huòdé le shènglì	It was a happy day when our football team was victorious.	2.444
我们遗憾地把我们的决定通知她。	wǒmen yíhàn dì bǎ wǒmen de juédìng tōngzhī tā	We informed her with regret of our decision.	2.444
她要他清理好他弄得乱七八糟的东西。	tā yào tā qīnglǐ hǎo tā nòng dé luànqībāzāo de dōngxi	She tell him to clear up the mess he have make.	2.455
要聘请到素质好的老师是很困难的。	yào pìnqǐng dào sùzhì hǎo de lǎoshī shì hěn kùnnan de	It’s difficult to recruit teachers of quality.	2.455
他的花白的头发显示出了他的年龄。	tā de huābái de tóufa xiǎnshì chū le tā de niánlíng	His hoary hair showed his age.	2.455
我正在用我新买的煎锅做苹果馅饼。	wǒ zhèngzài yòng wǒ xīn mǎi de jiānguō zuò píngguǒxiànbǐng	I am cooking apple pies with my newly bought frying pan.	2.455
我只要做的就是说服他跟我们一起去。	wǒ zhǐyào zuò de jiùshì shuōfú tā gēn wǒmen yīqǐ qù	All I have to do is persuade him to go with us.	2.455
我叔叔给了我一些钱让我开始经商。	wǒ shūshu gěi le wǒ yīxiē qián ràng wǒ kāishǐ jīngshāng	My uncle gave me some money to start me out in trade.	2.455
我已经足够大了，有权去做我喜欢做的事。	wǒ yǐjīng zúgòu dà le yǒuquán qù zuò wǒ xǐhuan zuò de shì	I’m old enough to have the freedom to do as I like.	2.462
我要是你就不参加了，他的计划似乎不妥当。	wǒ yàoshi nǐ jiù bù cānjiā le tā de jìhuà sìhū bù tuǒdang	I should lie off if I were you, his scheme doesn’t seem sound.	2.462
爱你的敌人吧，因为他们让你知道自己的缺点。	ài nǐ de dírén ba yīnwèi tāmen ràng nǐ zhīdào zìjǐ de quēdiǎn	Love your enemies, for they tell you your faults.	2.462
我卖给你一本新的地理书，其余的钱你可以能够还的时候还我。	wǒ mài gěi nǐ yī běn xīn de dìlǐ shū qíyú de qián nǐ kěyǐ nénggòu hái de shíhou hái wǒ	I’ll let you have the new geography and you may pay me the remainder of the money.	2.474
我经常乘地铁去上班。	wǒ jīngcháng chéng dìtiě qù shàngbān	I go to work on the tube.	2.5
你的衬衫已经熨好了。	nǐ de chènshān yǐjīng yù hǎole	Your shirt is already ironed.	2.5
未成熟的苹果是酸的。	wèi chéngshú de píngguǒ shì suān de	Green apples are sour.	2.5
他的书在柜子里找到了。	tā de shū zài guìzi lǐ zhǎo dàoliǎo	His book turned up in the cupboard.	2.5
你疯了吗？	nǐ fēng le ma	Are you insane?	2.5
他是我可以信赖的那一种人。	tā shì wǒ kěyǐ xìnlài de nà yīzhǒng rén	He is a man on whom I can rely.	2.5
小猫喝了牛奶，又洗了脸。	xiǎomāo hē le niúnǎi yòu xǐ le liǎn	The little cat drank its milk and washed its face.	2.5
我很想吃饺子。	wǒ hěn xiǎng chī jiǎozi	I feel like having some dumplings.	2.5
能看很远的，目光锐利的	néng kàn hěn yuǎn de mùguāng ruìlì de	Able to see far; keen-sighted.	2.5
他没怎么听讲。	tā méi zěnme tīngjiǎng	He paid scant attention to what was said.	2.5
她很有头脑。	tā hěn yǒu tóunǎo	She has a good brain.	2.5
杏仁能吃吗？	xìngrén néng chī ma	Are kernels of apricots edible?	2.5
不怎么想去，我并不大喜欢看电影。	bùzěnme xiǎng qù wǒ bìng bùdà xǐhuan kàn diànyǐng	Not really. I am not very fond of the cinema.	2.5
现在再见了！	xiànzài zàijiàn le	Bye for now！	2.5
你觉得恶心吗？	nǐ juéde ěxīn ma	Be you feeling nausea?	2.5
他假装在爬山。	tā jiǎzhuāng zài páshān	He was pretending to climb a mountain.	2.5
他是幕后策划人。	shèbèi zhōng yǒu gùzhàng	He is behind the plan.	2.5
你喜欢香港吗？	nǐ xǐhuan Xiānggǎng ma	How do you like Hong Kong?	2.5
你喜欢流行音乐吗？	nǐ xǐhuan liúxíngyīnyuè ma	Do you like popular music?	2.5
我的鞋底都断了。	wǒ de xiédǐ dōu duàn le	The soles of my shoes are broken.	2.5
他的红墨水用完了。	tā de hóngmòshuǐ yòngwán le	He has run out of red ink.	2.5
这完全是你的过错。	zhè wánquán shì nǐ de guòcuò	It’s your fault entirely.	2.5
他不得不迁就他的弟弟。	tā bùdébù qiānjiù tā de dìdi	He has to appease his young brother.	2.5
他招手叫我走过去。	tā zhāoshǒu jiào wǒ zǒu guòqu	He beckoned me to come nearer.	2.5
你没锁门，太粗心了。	nǐ méi suǒmén tài cūxīn le	It was careless of you to leave the door unlocked.	2.5
他是个幸运的家伙。	tā shì gè xìngyùn de jiāhuo	He is a lucky dog.	2.5
不协调的；不和谐的	bùxiétiáo de bù héxié de	Lacking in harmony.	2.5
你税后的工资是多少？	nǐ shuìhòu de gōngzī shì duōshao	What are your earnings after tax?	2.5
他的脉搏不很规则。	tā de màibó bùhěn guīzé	His pulse is not very regular.	2.5
我有个简易的方法。	wǒ yǒu gè jiǎnyì de fāngfǎ	I have a simple and easy method.	2.5
那个学生昨天丢了书。	nàge xuésheng zuótiān diū le shū	That student lost his book yesterday.	2.5
他很敬佩他的父亲。	tā hěn jìngpèi tā de fùqīn	He has a great respect for his father.	2.5
他的诚实是无可争议的。	tā de chéngshí shì wúkě zhēngyì de	His honesty is beyond dispute.	2.5
老师赞扬了她的勇气。	lǎoshī zànyáng le tā de yǒngqì	The teacher praised her for her courage.	2.5
你的初步措施是什么？	nǐ de chūbù cuòshī shì shénme	What are your preparatory measures?	2.5
老师正在评定学生的作业。	lǎoshī zhèngzài píngdìng xuésheng de zuòyè	The teacher is appraising the students’ work.	2.5
你是想让我难堪吗？	nǐ shì xiǎng ràng wǒ nánkān ma	Are you trying to embarrass me?	2.5
还是我直接跟他打交道为好	háishi wǒ zhíjiē gēn tā dǎjiāodào wéi hǎo	I prefer to deal with him direct.	2.5
你认为他当真要离开公司吗？	nǐ rènwéi tā dāngzhēn yào líkāi gōngsī ma	Do you think he is serious about leaving the company?	2.5
他骗我把自行车借给了他。	tā piàn wǒ bǎ zìxíngchē jiègěi le tā	He beguiled me into lending him my bicycle.	2.5
把我应付你的钱都加在一起。	bǎ wǒ yìngfu nǐ de qián dōu jiā zàiyīqǐ	Add up all the money I owe you.	2.5
她的微笑掩饰了她的感情。	tā de wēixiào yǎnshì le tā de gǎnqíng	Her smile masked true feelings.	2.5
我对电脑的维修保养很在行。	wǒ duì diànnǎo de wéixiū bǎoyǎng hěn zàiháng	Maintenance of PC is in my element.	2.5
我是最不可能去尝试回答这个问题。	wǒ shì zuì bùkěnéng qù chángshì huídá zhège wèntí	I would be the last to attempt to answer the question.	2.5
我准备花多少钱是有限度的。	wǒ zhǔnbèi huā duōshao qián shì yǒuxiàn dù de	There’s a limit to how much I’m prepared to spend.	2.5
你们有适合我穿的现成的衣服吗？	nǐmen yǒu shìhé wǒ chuān de xiànchéng de yīfu ma	Do you have anything ready- make that will fit me?	2.5
有道理，我认为那是非常公道的价格。	yǒudàoli wǒ rènwéi nàshi fēicháng gōngdào de jiàgé	Fair enough, I think that’s a very reasonable price.	2.5
关于此事，你能给我提供什么消息吗？	guānyú cǐ shì nǐ néng gěi wǒ tígōng shénme xiāoxi ma	Can you give me any information on this matter?	2.5
老师问了我一些和我的论文有关的问题。	lǎoshī wèn le wǒ yīxiē hé wǒ de lùnwén yǒuguān de wèntí	The teacher asked me some questions relative to my paper.	2.5
你住在哪儿？	nǐ zhù zàinǎr	Where do you live?	2.5
一提到他的名字，他立即站了起来。	yī tídào tā de míngzi tā lìjí zhàn le qilai	At the mention of his name, he instantly stood up.	2.5
听到这消息我很高兴。	tīngdào zhè xiāoxi wǒ hěn gāoxìng	I’m glad to hear that	2.5
万一我忘记，请提醒我。	wànyī wǒ wàngjì qǐng tíxǐng wǒ	In case (=If) I forget, please remind me.	2.5
我向他们做了明白的解释。	wǒ xiàng tāmen zuò le míngbai de jiěshì	I made a lucid explanation to them.	2.5
我不完全理解他离开的理由。	wǒ bù wánquán lǐjiě tā líkāi de lǐyóu	I don’t fully understand his reasons for leaving.	2.5
他几乎破产了。	tā jīhū pòchǎn le	He is practically ruined.	2.5
我打算娶她。	wǒ dǎsuàn qǔ tā	I’m going to marry her.	2.5
我的儿子每晚都去上补习班。	wǒ de érzi měi wǎn dōu qù shàng bǔxíbān	My son go to cram school every evening.	2.5
那是历史上最严重的空难。	nàshi lìshǐshàng zuì yánzhòng de kōngnàn	That was the worst airline disaster in history.	2.5
谁迟到谁倒霉！	shéi chídào shéi dǎoméi	Woe betide anyone who arrives late！	2.5
我也不相信我们的相关力量正在增长。	wǒ yě bù xiāngxìn wǒmen de xiāngguān lìliang zhèngzài zēngzhǎng	I don’t believe that our relative strength is increasing.	2.5
我们为什么要怕他呢？	wǒmen wèishénme yào pà tā ne	Why is it that we should be afraid of him?	2.5
感谢你的邀请。	gǎnxiè nǐ de yāoqǐng	I appreciate your invitation.	2.5
你介意我明天请假吗？	nǐ jièyì wǒ míngtiān qǐngjià ma	Are you mind if I take tomorrow off?	2.5
发掘过去的历史是不容易的。	fājué guòqu de lìshǐ shì bù róngyì de	It is not easy to dig out the past.	2.5
他胃不舒服。	tā wèi bùshūfu	He has an upset stomach.	2.5
他很倒霉，在考试当天生病了。	tā hěn dǎoméi zài kǎoshì dàngtiān shēngbìng le	He had the misfortune to fall ill on the day of the examination.	2.5
没关系。有什么事？	méiguānxi yǒu shénmeshì	It doesn’t matter. What’s up?	2.5
我们都支持他的科学研究。	wǒmen dōu zhīchí tā de kēxuéyánjiū	We all support his scientific research.	2.5
她在剧团工作。	tā zài jùtuán gōngzuò	She works in a theatrical company.	2.5
他很容易打交道。	tā hěn róngyì dǎjiāodào	He is easy to deal with.	2.5
他竟然拒绝了！	tā jìngrán jùjué le	He actually refused！	2.5
他在医务界工作。	tā zài yīwù jiè gōngzuò	He is a member of the medical fraternity.	2.5
他紧张地坐着，整理着他的思绪。	tā jǐnzhāng dì zuò zhe zhěnglǐ zhe tā de sīxù	He sat nervously, marshal his thought.	2.5
由于他的参与，我们赢了比赛。	yóuyú tā de cānyù wǒmen yíng le bǐsài	We win the game because of his participation.	2.5
我为准备英语考试的人做辅导。	wǒ wéi zhǔnbèi Yīngyǔ kǎoshì de rén zuò fǔdǎo	I coach people for English exams.	2.5
她对孩子和动物总是很温柔。	tā duì háizi hé dòngwù zǒngshì hěn wēnróu	She always shows kindness to children and animals.	2.5
我们在危险的时候应该保持冷静。	wǒmen zài wēixiǎn de shíhou yīnggāi bǎochí lěngjìng	We should keep our composure in danger.	2.5
我们的人口在增长，因此我们需要更多的食物。	wǒmen de rénkǒu zài zēngzhǎng yīncǐ wǒmen xūyào gèng duō de shíwù	We have a growing population and therefore we need more food.	2.5
我们考虑是否要告诉她。	wǒmen kǎolǜ shìfǒu yào gàosu tā	We pondered whether to tell her.	2.5
他和往常一样努力工作。	tā hé wǎngcháng yīyàng nǔlì gōngzuò	He works as hard as ever.	2.5
认识从实践开始。	rènshi cóng shíjiàn kāishǐ	Knowledge begin with practice.	2.5
你必须专心学习。	nǐ bìxū zhuānxīn xuéxí	You must pay attention to your study.	2.5
我们必须重新开始。	wǒmen bìxū chóngxīnkāishǐ	We must make a new start.	2.5
我的书法很好，但与我父亲的相比，我的就很差了。	wǒ de shūfǎ hěn hǎo dàn yǔ wǒ fùqīn de xiāngbǐ wǒ de jiù hěn chà le	My handwriting is good, but it is poor as compared to my father’s.	2.529
我感到了猫在我的腿上蹭来蹭去。	wǒ gǎn dàoliǎo māo zài wǒ de tuǐ shàng cèng lái cèng qù	I could feel the cat rubbing up against my leg.	2.538
他是个优秀的运动员，他所有的动作都非常协调。	tā shì gè yōuxiù de yùndòngyuán tā suǒyǒu de dòngzuò dōu fēicháng xiétiáo	He is an excellent athlete; all his movements are perfectly coordinated.	2.538
我还没来得及给他盖好被子，他就睡着了。	wǒ hái méi láidejí gěi tā gài hǎo bèizi tā jiù shuìzháo le	He was asleep before I tucked him in.	2.538
今天的报纸上有一篇关于办公室里的性骚扰的报道。	jīntiān de bàozhǐ shàng yǒu yī piān guānyú bàngōngshì lǐ de xìngsāorǎo de bàodào	There is a report about a sexual harassment in the office on this newspaper.	2.538
我代表我的同事和我本人向你表示感谢。	wǒ dàibiǎo wǒ de tóngshì hé wǒ běnrén xiàng nǐ biǎoshì gǎnxiè	On behalf of my colleagues and myself I thank you.	2.545
她的亲切给我留下了很深的印象。	tā de qīnqiè gěi wǒ liúxià le hěn shēn de yìnxiàng	Her gentleness has given me a deep impression.	2.545
我的新秘书很好，确实是难得的人才。	wǒ de xīn mìshū hěn hǎo quèshí shì nándé de réncái	My new secretary is very good; quite a find, in fact.	2.545
如果你愿意卖的话，我想买你的房子。	rúguǒ nǐ yuànyì mài dehuà wǒ xiǎng mǎi nǐ de fángzi	I’d like to buy your house if you are willing to sell it.	2.545
请允许我（向你）介绍我的新助手。	qǐng yǔnxǔ wǒ xiàng nǐ jièshào wǒ de xīn zhùshǒu	May I present my new assistant (to you).	2.545
她不知道以后等待她的将是什么命运。	tā bù zhīdào yǐhòu děngdài tā de jiāng shì shénme mìngyùn	She wondered what fate had in store for her next.	2.545
我想我们今天的讨论大家都谈得差不多了。让我的秘书来送诸位出去吧。	wǒ xiǎng wǒmen jīntiān de tǎolùn dàjiā dōu tán dé chàbuduō le ràng wǒ de mìshū lái sòng zhūwèi chūqù ba	I think that just about concludes our discussion. Let my secretary show you out.	2.55
她的裙子上有个细长的开口。	tā de qúnzi shàng yǒu gè xìcháng de kāikǒu	Her skirt has a long slit.	2.556
咱们一起复习你的英语练习好吗？	zánmen yīqǐ fùxí nǐ de Yīngyǔ liànxí hǎo ma	Shall we go over your English exercises together?	2.556
他喜欢在周末看滑稽剧来放松自己。	tā xǐhuan zài zhōumò kàn huájī jù lái fàngsōng zìjǐ	He likes to watch farces at weekends to relax himself.	2.556
这房间给人非常温暖舒适的感觉。	zhè fángjiān gěi rén fēicháng wēnnuǎn shūshì de gǎnjué	The room has a nice cosy feel.	2.556
他是去年六月开始在这里工作的。	tā shì qùnián Liùyuè kāishǐ zài zhèlǐ gōngzuò de	He started work here last June.	2.556
我希望这本书的字再大一点儿。	wǒ xīwàng zhè běn shū de zì zài dà yīdiǎnr	I wish this book was written in bigger character.	2.556
他那无聊的闲扯会使你烦恼。	tā nà wúliáo de xiánchě huì shǐ nǐ fánnǎo	His silly chatter would vex you.	2.556
他经常按他妻子的吩咐去做。	tā jīngcháng àn tā qīzi de fēnfù qù zuò	He often does his wife’s bidding.	2.556
那城市有自己的公用图书馆和公园。	nà chéngshì yǒu zìjǐ de gōngyòng túshūguǎn hé gōngyuán	The town has its own public library and public gardens.	2.556
她那抑郁的心情一会儿就过去了。	tā nà yìyù de xīnqíng yīhuìr jiù guòqu le	Her feeling of depression was transient.	2.556
从那个观点看，这工作就容易了。	cóng nàge guāndiǎn kàn zhè gōngzuò jiù róngyì le	Look at from that point of view, the job become easy.	2.556
他带着心满意足的微笑告诉了我们。	tā dài zhe xīnmǎnyìzú de wēixiào gàosu le wǒmen	He told us with a smile of contentment.	2.556
有足够的钱的；富裕的	yǒu zúgòu de qián de fùyù de	Having plenty of money; prosperous.	2.571
这条裤子我穿太紧了。	zhè tiáo kùzi wǒ chuān tài jǐn le	This pair of trousers is too tight for me.	2.571
他的动机是好的。	tā de dòngjī shì hǎo de	He was acting from the best of motives.	2.571
我觉得我有义务不这样。	wǒ juéde wǒ yǒu yìwù bù zhèyàng	I feel it is my duty not to.	2.571
他（跟你）是亲戚吗？	tā gēn nǐ shì qīnqi ma	Is he any relation (to you)?	2.571
这房间的面积是多少？	zhè fángjiān de miànjī shì duōshao	What are the dimensions of the room?	2.571
那电影的情节是老掉牙的。	nà diànyǐng de qíngjié shì lǎodiàoyá de	The film had a rather tired plot.	2.571
她是我们公司的一位秘书。	tā shì wǒmen gōngsī de yī wèi mìshū	She is a secretary in our company.	2.571
我丈夫是一个善良的人。	wǒ zhàngfu shì yī gè shànliáng de rén	My husband is a kind person.	2.571
他被他的老板解雇了。	tā bèi tā de lǎobǎn jiěgù le	He was fired by his boss.	2.571
他和我力气一样大。	tā hé wǒ lìqi yīyàng dà	He’s my equal in strength.	2.571
他在最适当的时候到达。	tā zài zuì shìdàng de shíhou dàodá	He arrived at the most opportune moment.	2.571
两把椅子坐起来都不舒服。	liǎng bǎ yǐzi zuò qilai dōu bùshūfu	Neither chair is comfortable.	2.571
谨慎是那人性格的本质。	jǐnshèn shì nà rén xìnggé de běnzhì	Caution is the essence of that man’s character.	2.571
她向他表示衷心的感谢。	tā xiàng tā biǎoshì zhōngxīn de gǎnxiè	She gave him her heartfelt thanks.	2.571
她急于要告诉你这消息。	tā jíyú yào gàosu nǐ zhè xiāoxi	She is burning to tell you the news.	2.571
你缺席的真正原因是什么？	nǐ quēxí de zhēnzhèng yuányīn shì shénme	What was the real reason for your absence?	2.571
你把结果算对了吗？	nǐ bǎ jiéguǒ suàn duìle ma	Did you get the answer right?	2.571
我是最近才开始学法语的。	wǒ shì zuìjìn cái kāishǐ xué Fǎyǔ de	I’ve only recently started learning French.	2.571
我实在讨厌让我等着。	wǒ shízài tǎoyàn ràng wǒděng zhe	I really hate being kept waiting.	2.571
我始终认为帮助别人是重要的。	wǒ shǐzhōng rènwéi bāngzhù biéren shì zhòngyào de	I always make a point of giving a hand to others.	2.571
我丈夫是一个孝顺的儿子。	wǒ zhàngfu shì yī gè xiàoshùn de érzi	My husband is a filial son.	2.571
使学生学习是教师的责任。	shǐ xuésheng xuéxí shì jiàoshī de zérèn	It’s a teacher’s business to make student learn.	2.571
律师向我们解释了新法律。	lǜshī xiàng wǒmen jiěshì le xīn fǎlǜ	The lawyer explained the new law to us.	2.571
他努力控制住自己的脾气。	tā nǔlì kòngzhì zhù zìjǐ de píqi	He struggled to control his temper.	2.571
我是唯一明了老师真正在说什么的人。	wǒ shì wéiyī míngliǎo lǎoshī zhēnzhèng zài shuō shénmede rén	I am the only one to pick up on what the teacher is really saying.	2.583
要准时来，否则你会给人一个坏的印象。	yào zhǔnshí lái fǒuzé nǐ huì gěi rén yī gè huài de yìnxiàng	Be there on time, otherwise you’ll create a bad impression.	2.583
她羞怯地从她的扇子后面看了他一眼。	tā xiūqiè dì cóng tā de shànzi hòumian kàn le tā yīyǎn	She glanced shyly at him from behind her fan.	2.583
我想他会拒绝的。我恰恰认为她是个固执已见的人，做这种事当然不合乎她的习惯。	wǒ xiǎng tā huì jùjué de wǒ qiàqià rènwéi tā shì gè gùzhí yǐ jiàn de rén zuò zhèzhǒng shì dāngrán bù héhū tā de xíguàn	I expected her to refuse. I just thought of her as set in her ways, and this sort of thing certainly wasn’t among her habits.	2.583
不管有什么困难，他都要继续推行他的计划。	bùguǎn yǒu shénme kùnnan tā dōu yào jìxù tuīxíng tā de jìhuà	He’ll push on with his project whatever the difficulties may be.	2.583
她对他的影响非常大，以至于完全控制了他。	tā duì tā de yǐngxiǎng fēicháng dà yǐzhìyú wánquán kòngzhì le tā	Her interest with him is such that she governs him absolutely.	2.583
丹在学校是个好学生；我们期望他经商成功。	dān zài xuéxiào shì gè hǎo xuésheng wǒmen qīwàng tā jīngshāng chénggōng	Dan was a good student at school; we expect him to go places in business.	2.583
谁把我写在黑板上的数字擦掉了？	shéi bǎ wǒ xiě zài hēibǎn shàng de shùzì cādiào le	Who’s rubbed my figures off the blackboard?	2.583
你的鼓励使我对我的未来更加有信心。	nǐ de gǔlì shǐ wǒ duì wǒ de wèilái gèngjiā yǒu xìnxīn	Your encouragement made me more confident of my future.	2.583
只要把它完成了，你怎么做我并不计较。	zhǐyào bǎ tā wánchéng le nǐ zěnme zuò wǒ bìngbù jìjiào	I’m not particular how you do it as long as it gets done.	2.583
如果你同意我的意见，就明白地回答“是”。	rúguǒ nǐ tóngyì wǒ de yìjiàn jiù míngbai dì huídá shì	Answer with a plain “yes” if you agree with me.	2.583
他比她高5公分。	tā bǐ tā gāo gōngfēn	He is 5 centimeters taller than her.	2.6
陪我的是一位高先生，他是医院院长。	péi wǒ de shì yī wèi gāo xiānsheng tā shì yīyuàn yuànzhǎng	Accompanying me was a Mr.Kao, director of the hospital.	2.6
我的电话坏了。	wǒ de diànhuà huài le	My phone was out of order.	2.6
我只想说对不起。	wǒ zhǐ xiǎng shuō duìbuqǐ	I want to say nothing but sorry.	2.6
我喜欢节奏快的音乐。	wǒ xǐhuan jiézòu kuài de yīnyuè	I like fast music.	2.6
你喜欢姜汁啤酒吗？	nǐ xǐhuan jiāngzhī píjiǔ ma	Do you like ginger beer?	2.6
老师不应该体罚学生。	lǎoshī bù yīnggāi tǐfá xuésheng	A teacher should not give students corporal punishment.	2.6
如果你在雾天去爬山，你是在自讨苦吃。	rúguǒ nǐ zài wù tiān qù páshān nǐ shì zài zìtǎokǔchī	If you climb mountain in fog, you are asking for it.	2.6
她使她的手指和我的手指交错。	tā shǐ tā de shǒuzhǐ hé wǒ de shǒuzhǐ jiāocuò	She interlaced her fingers with mine.	2.6
我在街上遇到他。	wǒ zài jiēshang yùdào tā	I met him in the street.	2.6
你使我非常为难。	nǐ shǐ wǒ fēicháng wéinán	You place me in a very difficult position.	2.6
请接受我的慰问。	qǐng jiēshòu wǒ de wèiwèn	Please accept my condolences.	2.6
我想买一台空调。	wǒ xiǎng mǎi yī tái kōngtiáo	I want to buy a set of air conditioning.	2.6
我在这家商店里买了一品脱牛奶。	wǒ zài zhè jiā shāngdiàn lǐ mǎi le yīpǐn tuō niúnǎi	I bought a pint of milk in the store.	2.6
她一大早就起床了。	tā yīdàzǎo jiù qǐchuáng le	She rose with the lark.	2.6
她觉察到她的机会。	tā juéchá dào tā de jīhuì	She awoke to her opportunity.	2.6
写作是他的生命。	xiězuò shì tā de shēngmìng	Writing is his life.	2.6
他没多少文化修养。	tā méi duōshao wénhuà xiūyǎng	He is a man of little culture.	2.6
我再一考虑，反倒觉得可能还是她对。	wǒ zài yī kǎolǜ fǎndào juéde kěnéng háishi tā duì	On further reflection, I saw that she might be right, after all.	2.6
我一觉醒来，发现我所有的衣服不翼而飞。	wǒ yījiàoxǐnglái fāxiàn wǒ suǒyǒu de yīfu bùyì’érfēi	I awoke from sleep to find that all my clothes had disappeared.	2.6
你相信有仙女吗？	nǐ xiāngxìn yǒu xiānnǚ ma	Do you believe in fairies?	2.6
我相信他的誓言。	wǒ xiāngxìn tā de shìyán	I believe his troth.	2.6
他是自己掏腰包的。	tā shì zìjǐ tāoyāobāo de	He paid for it out of his own pocket.	2.6
说不定他已经死了。	shuōbudìng tā yǐjīng sǐ le	He may be dead for aught I know.	2.6
他有早起的习惯。	tā yǒu zǎoqǐ de xíguàn	He is in the habit of rising early.	2.6
他的职业是经商。	tā de zhíyè shì jīngshāng	He is a merchant in occupation.	2.6
很明显，他是罪犯。	hěn míngxiǎn tā shì zuìfàn	It’s plain that he is the criminal.	2.6
他的朋友很少，因此他的生活非常孤单。	tā de péngyou hěn shǎo yīncǐ tā de shēnghuó fēicháng gūdān	He has so few friends that his life is lonely.	2.6
我认为那电影不怎么样。	wǒ rènwéi nà diànyǐng bùzěnmeyàng	I don’t think much of the movie.	2.6
我通常大概7点起床。	wǒ tōngcháng dàgài diǎn qǐchuáng	I used to get up at about seven.	2.6
你对气功怎么看？	nǐ duì qìgōng zěnme kàn	How do you feel about Qigong?	2.6
我特别不喜欢洋葱。	wǒ tèbié bù xǐhuan yángcōng	I especially dislike onions.	2.6
我丈夫和我都喜欢乡村的宁静生活。	wǒ zhàngfu hé wǒ dōu xǐhuan xiāngcūn de níngjìng shēnghuó	Both my husband and I love the tranquil life in the country.	2.6
我不太满意他对这个句子的翻译。	wǒ bù tài mǎnyì tā duì zhège jùzi de fānyì	I’m not satisfied with his interpretation of this sentence.	2.6
尽管他帮助过我，可是我还是恨他。	jǐnguǎn tā bāngzhù guò wǒ kěshì wǒ háishi hèn tā	I hate him albeit he helped me.	2.6
车祸夺去了他的妻子和儿子的生命。	chēhuò duó qù le tā de qīzi hé érzi de shēngmìng	The accident bereaved him of his wife and child.	2.6
六十分等于一小时。	liùshí fēn děngyú yī xiǎoshí	Sixty minutes is equal to an hour.	2.6
他发誓永远爱她。	tā fāshì yǒngyuǎn ài tā	He swore to love her for evermore.	2.6
我们想去参加化装舞会。	wǒmen xiǎng qù cānjiā huàzhuāng wǔhuì	We want to join in the masquerade.	2.6
如果你到今晚把手头上的工作做完，你明天就可以休息。	rúguǒ nǐ dào jīnwǎn bǎshǒu tóushàng de gōngzuò zuòwán nǐ míngtiān jiù kěyǐ xiūxi	Provided/Providing (that) you clear your desk by this evening, you can have tomorrow off.	2.6
我并不了解讨论的情况，所以无法告诉你做了什么决定。	wǒ bìngbù liǎojiě tǎolùn de qíngkuàng suǒyǐ wúfǎ gàosu nǐ zuò le shénme juédìng	I was not privy to the discussion, so I cannot tell you what was decided.	2.6
你打算做什么？	nǐ dǎsuàn zuò shénme	What do you plan to do?	2.6
他不愿意受到打扰。	tā bù yuànyì shòudào dǎrǎo	He did not care to be disturbed.	2.6
我们白天工作晚上休息。	wǒmen báitiān gōngzuò wǎnshang xiūxi	We work in the day and rest at night.	2.6
我们认为他值得信任。	wǒmen rènwéi tā zhíde xìnrèn	We esteem him to be worthy of trust.	2.6
能和你在一起对我是件极为安慰的事。	néng hé nǐ zàiyīqǐ duì wǒ shì jiàn jíwéi ānwèi de shì	Your company has been a great consolation to me.	2.615
在自由市场上，那个男人卖给我坏鸡蛋骗了我。	zài zìyóushìchǎng shàng nàge nánrén mài gěi wǒ huài jīdàn piàn le wǒ	That man in the free market put it across me by selling me some bad eggs.	2.615
我请他去给我晚报拿来。	wǒ qǐng tā qù gěi wǒ wǎnbào nálái	I asked him to fetch me the evening paper.	2.625
他给我买了两只小乌龟。	tā gěi wǒ mǎi le liǎng zhǐ xiǎo wūguī	He bought two small tortoises for me.	2.625
他警告我晚上不要到那去。	tā jǐnggào wǒ wǎnshang bùyào dào nà qù	He warned me against going there at night.	2.625
他没吃早饭就去上学了。	tā méi chī zǎofàn jiù qù shàngxué le	He went to school without breakfast. (=He went to school and did not eat breakfast.)	2.625
要找他时，他偏偏不在。	yào zhǎo tā shí tā piānpiān bùzài	He must needs go away when he was wanted.	2.625
别哭，你现在已经是大男孩了。	bié kū nǐ xiànzài yǐjīng shì dà nánhái le	Don’t cry, you are a big boy now.	2.625
我可不喜欢整天和他在一起。	wǒ kě bù xǐhuan zhěngtiān hé tā zàiyīqǐ	I’m not too enamored with the idea of spending a whole day with him.	2.625
那男孩今天早上吃了三碗米饭。	nà nánhái jīntiān zǎoshang chī le sān wǎn mǐfàn	The boy ate three bowls of rice this morning.	2.625
您想买进口的还是国产的？	nín xiǎng mǎi jìnkǒu de háishi guóchǎn de	Do you want an import brand or a home-make one?	2.625
休息一下对你会有好处的。	xiūxi yīxià duì nǐ huì yǒuhǎochù de	It’ll do you good to have a rest.	2.625
我想看见他受辱，他使别人吃苦，也让他吃同样的苦。	wǒ xiǎng kànjiàn tā shòurǔ tā shǐ biéren chīkǔ yě ràng tā chī tóngyàng de kǔ	I like to see him in the dust, suffering as much as he had made others suffer.	2.625
她的书法有了明显的进步。	tā de shūfǎ yǒule míngxiǎn de jìnbù	There’s been a noticeable improvement in her handwriting.	2.625
我不和我的老板谈私事。	wǒ bùhé wǒ de lǎobǎn tán sīshì	I don’t talk with my boss about my private matters.	2.625
我认为他是更合适的人选。	wǒ rènwéi tā shì gèng héshì de rénxuǎn	In my estimation, he is a more suitable candidate.	2.625
她对服装有很好的审美眼光。	tā duì fúzhuāng yǒu hěn hǎo de shěnměiyǎnguāng	She has good taste in clothes.	2.625
他给他的汽车装了空调。	tā gěi tā de qìchē zhuāng le kōngtiáo	He equipped his car with air conditioning.	2.625
我向他表达了诚挚的问候。	wǒ xiàng tā biǎodá le chéngzhì de wènhòu	I send my regards to him with earnestness.	2.625
你猜我今天碰见谁了？	nǐ cāi wǒ jīntiān pèngjiàn shéi le	Guess who I bumped into today?	2.625
你猜我今天碰见谁了。	nǐ cāi wǒ jīntiān pèngjiàn shéi le	Guess who I ran into today.	2.625
她对她的孩子们很严格。	tā duì tā de háizimen hěn yángé	She is strict with her children.	2.625
她干的工作比别人要好些。	tā gàn de gōngzuò bǐ biéren yàohǎo xiē	Her work is a cut above that of the others.	2.625
那是个小巧玲珑的开罐头工具。	nàshi gè xiǎoqiǎolínglóng de kāi guàntou gōngjù	It’s an artful little gadget for opening tins.	2.625
她知道金属为什么是好的导体。	tā zhīdào jīnshǔ wèishénme shì hǎo de dǎotǐ	She knows why the metal is the good conductor.	2.625
她把她的意思解释得清清楚楚。	tā bǎ tā de yìsi jiěshì dé qīng qīngchu chǔ	She made her meaning crystal clear.	2.625
我已经准备好与你较量力气。	wǒ yǐjīng zhǔnbèi hǎo yǔ nǐ jiàoliàng lìqi	I’m ready to match my strength against yours.	2.625
再呆10个星期，一共3个月。	zài dāi gè xīngqī yīgòng gè yuè	Another ten weeks three months altogether.	2.625
她往餐具柜里放了些盘子。	tā wǎng cānjù guì lǐ fàng le xiē pánzi	She put some plates in the sideboard.	2.625
我们大家比以往更需要努力工作。	wǒmen dàjiā bǐ yǐwǎng gèng xūyào nǔlì gōngzuò	It is more necessary than ever for all of us to work hard.	2.625
我把手套落在公共汽车上了。	wǒ bǎ shǒutào luò zài gōnggòngqìchē shàng le	I’ve left my gloves on the bus.	2.625
我十分乐意为你做任何事情。	wǒ shífēn lèyì wéi nǐ zuò rènhé shìqing	I am quite willing to do anything for you.	2.625
我儿子六岁的时候开始学习乘法。	wǒ érzi liù suì de shíhou kāishǐ xuéxí chéngfǎ	My son began to study multiplication when he was six.	2.625
他对你给他的东西没流露出一丝兴趣。	tā duì nǐ gěi tā de dōngxi méi liúlùchū yī sī xìngqù	He showed no glimmer of interest in what you had offered.	2.636
照我的和大多数人的看法，这是很可靠的投资。	zhào wǒ de hé dàduōshù rén de kànfǎ zhè shì hěn kěkào de tóuzī	In my opinion and in the opinion of most people, it is a very sound investment.	2.643
好主意。我们或者吃汉堡包或者吃中餐。你更喜欢哪一样？	hǎo zhǔyi wǒmen huòzhě chī hànbǎobāo huòzhě chī Zhōngcān nǐ gèng xǐhuan nǎ yīyàng	Great idea. Let’s have either hamburgers or Chinese food. What’s your preference?	2.643
他的样子和他在电话中说话的声音反映的病情是一样的。	tā de yàngzi hé tā zài diànhuà zhōng shuōhuà de shēngyīn fǎnyìng de bìngqíng shì yīyàng de	He looks as ill as he sounded on the phone.	2.647
喂，服务员，这汤太咸了。	wèi fúwùyuán zhè tāng tài xián le	I say, waiter, the soup is too salty.	2.667
我可以用信用卡付款吗？	wǒ kěyǐ yòng xìnyòngkǎ fùkuǎn ma	May I pay by credit card?	2.667
我真的会想念你的。	wǒ zhēn de huì xiǎngniàn nǐ de	I’m really going to miss you.	2.667
他的书上个月出版了。	tā de shū shànggèyuè chūbǎn le	His book came out last month.	2.667
那是我想象不到的。	nàshi wǒ xiǎngxiàng bùdào de	That’s beyond the reach of my imagination.	2.667
他在半路走丢了。	tā zài bànlù zǒu diū le	He was lost on the way.	2.667
他一辈子都住在这里。	tā yībèizi dōu zhù zài zhèlǐ	He all lives here all one’s life.	2.667
有要紧的事把他叫走了。	yǒu yàojǐn de shì bǎ tā jiào zǒu le	Something urgent has called him away.	2.667
谁翻过我的文件了？	shéi fānguò wǒ de wénjiàn le	Who’s been rooting about among my papers?	2.667
我一点也不明白你在说些什么。	wǒ yīdiǎn yě bù míngbai nǐ zài shuō xiē shénme	I haven’t the slightest idea what you are talking about.	2.667
他的快活是虚假的。	tā de kuàihuo shì xū jiǎde	His cheerfulness is false.	2.667
他们嘱咐我去看他。	tāmen zhǔfù wǒ qù kàn tā	I was charged to go and see him.	2.667
所有的灯都熄灭了。	suǒyǒu de dēng dōu xīmiè le	All the light went out.	2.667
护士，我的脚非常冷，可以给我一只热水瓶吗？	hùshi wǒ de jiǎo fēicháng lěng kěyǐ gěi wǒ yī zhǐ rèshuǐpíng ma	My feet are as cold as ice, nurse. Can I have a hot water bottle?	2.667
她的武术练到家了。	tā de wǔshù liàn dàojiā le	She is expert at Chinese boxing.	2.667
她不在乎你是否喜欢她。	tā bùzàihu nǐ shìfǒu xǐhuan tā	She does not care whether you like her or not.	2.667
你完全不知道在那里是什么滋味。	nǐ wánquán bù zhīdào zài nàli shì shénme zīwèi	You have no conception of what it was like to be there.	2.667
事实是最顽强的东西。	shìshí shì zuì wánqiáng de dōngxi	Facts are stubborn things.	2.667
医生诊看了她的舌头。	yīshēng zhěn kàn le tā de shétou	The doctor looked at her tongue.	2.667
他喜欢吹牛。	tā xǐhuan chuīniú	He likes to throw the bull.	2.667
要不然他还会在教书，因为他的心仍然在课堂上和他的学生们在一起。	yàobùrán tā hái huì zài jiāoshū yīnwèi tā de xīn réngrán zài kètáng shàng hé tā de xuésheng men zàiyīqǐ	Otherwise he would still be teaching, because his heart and soul were still in the classroom with his students.	2.667
她本来会嫁给他的，但知道他是个流氓后，她就离开他了。	tā běnlái huì jià gěi tā de dàn zhīdào tā shì gè liúmáng hòu tā jiù líkāi tā le	She would have married him, but when she learned that he was a rascal, she parted with him.	2.667
你最好把我的书给我，否则我的测验将要不及格了。	nǐ zuìhǎo bǎ wǒ de shū gěi wǒ fǒuzé wǒ de cèyàn jiāngyào bùjígé le	You’d better give me my book, otherwise I’ll fail my test.	2.667
听你谈话（那口气），我还以为你是首相呢。	tīng nǐ tánhuà nà kǒuqì wǒ hái yǐwéi nǐ shì shǒuxiàng ne	To hear you talk, I’d think you were Prime Minister.	2.667
他那不光彩历史的揭露导致了他的辞职。	tā nà bùguāngcǎi lìshǐ de jiēlù dǎozhì le tā de cízhí	The revelation of his scandalous past led to his resignation.	2.667
他是一个有重要社会地位的人。	tā shì yī gè yǒu zhòngyào shèhuì dìwèi de rén	He is a person of important social status.	2.667
天气很暖和，我就把大衣脱了。	tiānqì hěn nuǎnhuo wǒ jiù bǎ dàyī tuō le	I took off my overcoat since it was warm.	2.667
他为我演奏了他的许多乐曲。	tā wéi wǒ yǎnzòu	He played many of his compositions for me.	2.667
你说话太不礼貌了，我已受够了。	nǐ shuōhuà tài bù lǐmào le wǒ yǐ shòugòu le	I’ve had enough of your impertinent words.	2.667
如果你不加紧努力，你考试会不及格的。	rúguǒ nǐ bù jiājǐn nǔlì nǐ kǎoshì huì bùjígé de	If you don’t pull your socks up, you’ll fail the exam.	2.667
上次考试他给我指点错了，所以我没及格。	shàngcì kǎoshì tā gěi wǒ zhǐdiǎn cuò le suǒyǐ wǒ méi jígé	He gave me a bum steer on the last exam that I failed.	2.667
我认为他对这个问题的评论是不正确的。	wǒ rènwéi tā duì zhège wèntí de pínglùn shì bùzhèngquè de	I think his commentary on this issue is not correct.	2.667
我记得她长着红头发。	wǒ jìde tā cháng zhe hóng tóufa	I recollect that she had red hair.	2.667
他去邮局买些邮票。	tā qù yóujú mǎi xiē yóupiào	He went to the post-office to buy some stamps.	2.667
他叫侍者拿菜单来。	tā jiào shìzhě ná càidān lái	He called the waiter to bring the menu.	2.667
他带着姐姐一同去。	tā dài zhe jiějie yītóng qù	He took his sister along with him.	2.667
他是我们产品的买主。	tā shì wǒmen chǎnpǐn de mǎizhǔ	He is a buyer of our products.	2.667
报纸上的这篇文章为他的演讲提供了启发。	bàozhǐ shàng de zhè piān wénzhāng wéi tā de yǎnjiǎng tígōng le qǐfā	The newspaper article provided him with fuel for his speech.	2.667
我很倒霉，丢了钥匙。	wǒ hěn dǎoméi diū le yàoshi	I was unfortunate to lose my keys.	2.667
这仅仅是调查的开始。	zhè jǐnjǐn shì diàochá de kāishǐ	It’s only the initiative of the investigation.	2.667
他对纪律是严格的。	tā duì jìlǜ shì yángé de	He is stern in his discipline.	2.667
他擦去铅笔的痕迹。	tā cā qù qiānbǐ de hénjì	He erases pencil marks.	2.667
你知道谁打破了窗户？	nǐ zhīdào shéi dǎpò le chuānghu	Do you know who broke the window?	2.667
你到底是什么意思？	nǐ dàodǐ shì shénme yìsi	What on earth do you mean?	2.667
我知道发生了什么事。	wǒ zhīdào fāshēng le shénmeshì	I know what happened.	2.667
医生检查我的耳朵。	yīshēng jiǎnchá wǒ de ěrduo	The doctor looked into my ears.	2.667
让我把我的零碎东西收拾起来。	ràng wǒ bǎ wǒ de língsuì dōngxi shōushi qilai	Let me get my bits and pieces together.	2.667
我真诚地希望他能接受别人的批评。	tā dāngshí kànqǐlái hǎoxiàng shénmeshì dōu méi fāshēng shìde	I sincerely hope that he can accept the criticism of others.	2.667
他请求我们帮他完成他的计划。	tā qǐngqiú wǒmen bāng tā wánchéng tā de jìhuà	He asked us to assist him in carrying through his plan.	2.667
这个悬而未决的问题什么时候能解决呢？	zhège xuán’érwèijué de wèntí shénmeshíhou néng jiějué ne	When will the pendent problem be solved?	2.667
你的意见是否代表其他学生的意见？	nǐ de yìjiàn shìfǒu dàibiǎo qítā xuésheng de yìjiàn	Are your opinions representative of the other students?	2.667
在桌上的银相框里有张她丈夫的照片。	zài zhuō shàng de yín xiàngkuàng lǐ yǒu zhāng tā zhàngfu de zhàopiàn	In a silver frame on the table there is a photograph of her husband.	2.667
你脚上的麻木感一会儿就会消失。	nǐ jiǎo shàng de mámù gǎn yīhuìr jiù huì xiāoshī	The numbness in your foot will soon pass off.	2.667
让我解释迟到的理由。	ràng wǒ jiěshì chídào de lǐyóu	Let me explain why I was late.	2.667
她在学习以提高自己的代数水平。	tā zài xuéxí yǐ tígāo zìjǐ de dàishù shuǐpíng	She was studying to build up her algebra.	2.667
多保重。再见。	duō bǎozhòng zàijiàn	Take care. bye！	2.667
我们说服她参加了宴会。	wǒmen shuōfú tā cānjiā le yànhuì	We argued her into joining us.	2.667
我们应该学习祖先的成就。	wǒmen yīnggāi xuéxí zǔxiān de chéngjiù	We should study our ancestral achievements.	2.667
我不能肯定已经领会您的意思。是不是您不满意您现在的工作。	wǒ bùnéng kěndìng yǐjīng lǐnghuì nín de yìsi shìbùshì nín bùmǎnyì nín xiànzài de gōngzuò	I am not certain I have grasped what you meant. Is it(that) you are not satisfy with your present job?	2.688
我喜欢书架上所有的书，但这本是我最喜欢的。	wǒ xǐhuan shūjià shàng suǒyǒu de shū dàn zhè běn shì wǒ zuì xǐhuan de	I like all the books on the shelf but this one is my favorite.	2.692
你可以在这本书的第一部分找到你要的资料。	nǐ kěyǐ zài zhè běn shū de dìyī bùfen zhǎodào nǐ yào de zīliào	You may find the information you need in the first portion of the book.	2.692
有一天我在去我叔叔家的路上迷失了方向。	yǒu yī tiān wǒ zài qù wǒ shūshu jiāde lùshang míshī le fāngxiàng	One day I lost myself on the way to my uncle’s house.	2.692
以牺牲健康来求得工作上的成功是不值得的。	yǐ xīshēng jiànkāng lái qiúdé gōngzuò shàng de chénggōng shì bùzhíde de	Success in your job is not worth the sacrifice of your health.	2.692
我喜欢夏天吃莴苣，我的兔子也喜欢。	wǒ xǐhuan xiàtiān chī wōjù wǒ de tùzi yě xǐhuan	I like to eat lettuce in summer, and so does my rabbit.	2.7
有多少人在争夺理事会的这一席位？	yǒu duōshao rén zài zhēngduó lǐshìhuì de zhè yī xíwèi	How many people are contesting this seat on the council?	2.7
你没有认识到她这一成就的重大意义。	nǐ méiyǒu rènshi dào tā zhè yī chéngjiù de zhòngdà yìyì	You haven’t realized the magnitude of her achievement.	2.7
菠菜豆腐是我最爱吃的一种菜。	bōcài dòufu shì wǒ zuì ài chī de yīzhǒng cài	Spinach with bean curd is one of my favourite dishes.	2.7
你注意到了这一点是够机灵的。	nǐ zhùyì dàoliǎo zhè yīdiǎn shì gòu jīling de	It was very sharp of you to have noticed that.	2.7
无忧无虑的无忧无虑的和不关心的；快活的	wúyōuwúlǜ de wúyōuwúlǜ de hé bù guānxīn de kuàihuo de	Carefree and nonchalant; jaunty.	2.7
物理和数学都是我喜欢的科目。	wùlǐ hé shùxué dōu shì wǒ xǐhuan de kēmù	Physics and maths are my favourite subjects.	2.7
在这件事情上我同他是一致的。	zài zhè jiàn shìqing shàng wǒ tóng tā shì yīzhì de	I am in accordance with him in this matter.	2.7
他被她那尖锐的问题弄得哑口无言。	tā bèi tā nà jiānruì de wèntí nòng dé yǎkǒuwúyán	He was struck dumb by her sharp question.	2.7
他那有趣的表演引起了观众的哄堂大笑。	tā nà yǒuqù de biǎoyǎn yǐnqǐ le guānzhòng de hōngtángdàxiào	His amusing performance caused a roar of laughter in the audience.	2.7
我工作时间是别人的两倍，可拿的钱却比谁都少，我感到十分委屈。	wǒ gōngzuòshíjiān shì biéren de liǎngbèi kě ná de qián què bǐ shéi dōu shǎo wǒ gǎndào shífēn wěiqu	I felt very hard done by when I got less money than anybody else, and I’d worked twice as long.	2.7
这只狗开始生病并且很快就死了。	zhè zhǐ gǒu kāishǐ shēngbìng bìngqiě hěn kuài jiù sǐ le	The dog began to sicken and soon died.	2.7
我舒适地靠在大沙发上，开始看小说。	wǒ shūshì dì kào zài dà shāfā shàng kāishǐ kàn xiǎoshuō	I nestled down on the big sofa and began to read novels.	2.7
如果你再迟到，老板就会把你解雇。	rúguǒ nǐ zài chídào lǎobǎn jiù huì bǎ nǐ jiěgù	If you are late again the boss will give you the sack.	2.7
我太生气了， 我一定要当面告诉她我对她的看法。	wǒ tài shēngqì le wǒ yīdìngyào dāngmiàn gàosu tā wǒ duì tā de kànfǎ	I am so angry that I’ll tell her to her face what I think of her.	2.706
美国来的人他都瞧不起。	Měiguó lái de rén tā dōu qiáobùqǐ	He’s disdainful of anyone from the USA.	2.714
这些书是指定给他的。	zhèxiē shū shì zhǐdìng gěi tā de	These books are destined for him.	2.714
这两个花样我都不喜欢。	zhè liǎng gè huāyàng wǒ dōu bù xǐhuan	I like neither of the designs. (=I don’t like either of the designs.)	2.714
我的厨房里有好几个勺子。	wǒ de chúfáng lǐ yǒu hǎo jǐge sháozi	There are several scoops in my kitchen.	2.714
她是个可以信赖的人。	tā shì gè kěyǐ xìnlài de rén	She’s a woman who can be depended on.	2.714
她是个和蔼可亲的人。	tā shì gè hé’ǎikěqīn de rén	She is a warm kindly person.	2.714
猫把我的围巾撕烂了。	māo bǎ wǒ de wéijīn sī làn le	The cat has torn my scarf to ribbons.	2.714
你领会我说的意思吗？	nǐ lǐnghuì wǒ shuō de yìsi ma	Do you grasp the point of what I said?	2.714
她喜欢随着快节奏的音乐跳舞。	tā xǐhuan suízhe kuài jiézòu de yīnyuè tiàowǔ	She loves to dance to fast music.	2.714
她喜欢炫耀她的精美衣服。	tā xǐhuan xuànyào tā de jīngměi yīfu	She likes to show off her fine clothes.	2.714
我从来不是爱挑拣的人。	wǒ cónglái bùshì ài tiāojiǎn de rén	I’m never one to pick and choose.	2.714
我先去定好座位吧。	wǒ xiān qù dìng hǎo zuòwèi ba	Suppose I reserve seats in advance.	2.714
我尽量找些东西给你穿。	wǒ jǐnliàng zhǎo xiē dōngxi gěi nǐ chuān	I’ll try and rake out something for you to wear.	2.714
在院子里我看见两只猫。	zài yuànzi lǐ wǒ kànjiàn liǎng zhǐ māo	I saw a couple of cats in the yard.	2.714
在我现在看来，他那时似乎在叹气，而我吃吃地笑是在隐藏我的尴尬。	zài wǒ xiànzài kànlai tā nàshí sìhū zài tànqì ér wǒ chī chī dì xiào shì zài yǐncáng wǒ de gāngà	It seems to me now that he sighed and that I tittered to hide my embarrassment.	2.714
这传统有多久的历史了？	zhè chuántǒng yǒu duōjiǔ de lìshǐ le	How far does the tradition go back?	2.714
我恨他那讨厌的品行。	wǒ hèn tā nà tǎoyàn de pǐnxíng	I hate his obnoxious behavior.	2.714
我因为严寒没出去看电影。	wǒ yīnwèi yánhán méi chūqù kàn diànyǐng	I did not go to the cinema because of the intense cold.	2.714
这是个关于国王的神话。	zhè shì gè guānyú guówáng de shénhuà	It is a mythology about the king.	2.714
她最主要的品质是善良。	tā zuì zhǔyào de pǐnzhì shì shànliáng	Her most essential quality is kindness.	2.714
今天下午你读的什么书？	jīntiān xiàwǔ nǐ dú de shénme shū	What is the book you are poring over this afternoon?	2.714
他的成功是勤奋工作的结果。	tā de chénggōng shì qínfèn gōngzuò de jiéguǒ	His success was consequent on his hard work.	2.714
从一开始他就进行回击。	cóng yī kāishǐ tā jiù jìnxíng huíjī	He hit back from the beginning.	2.714
她把糖搅和到咖啡里。	tā bǎ táng jiǎohuo dào kāfēi lǐ	She stirred the sugar into her coffee.	2.714
如果天不晴，我们就不去散步。	rúguǒ tiān bù qíng wǒmen jiù bù qù sànbù	If the weather doesn’t clear, we won’t go for a walk.	2.714
我弄不明白他为什么缺席。	wǒ nòng bù míngbai tā wèishénme quēxí	I can’t figure out why he is absent.	2.714
我们的要求的核心是言论自由。	wǒmen de yāoqiú de héxīn shì yánlùnzìyóu	The core of our appeal is freedom of speech.	2.714
他个子小但身体很健康。	tā gèzi xiǎo dàn shēntǐ hěn jiànkāng	He was small and healthily built.	2.714
你必须提前两小时到达机场。	nǐ bìxū tíqián liǎng xiǎoshí dàodá jīchǎng	You must arrive at the airport two hours early.	2.714
他不断要求我们帮助他，过分利用了我们对他的好意。	tā bùduàn yāoqiú wǒmen bāngzhù tā guòfèn lìyòng le wǒmen duì tā de hǎoyì	His constant requests for help taxed our goodwill.	2.714
那位体贴的丈夫对妻子的关怀使她感觉很不高兴。	nà wèi tǐtiē de zhàngfu duì qīzi de guānhuái shǐ tā gǎnjué hěn bù gāoxìng	The solicitude of the caring husband for his wife made her feel unhappy.	2.714
他笑着告诉我这个消息。	tā xiào zhe gàosu wǒ zhège xiāoxi	He told me the news with a laugh.	2.714
我们要为新娘的健康干杯。	wǒmen yào wéi xīnniáng de jiànkāng gānbēi	We must drink to the health of the bride.	2.714
我们会尽力来达到世界水平。	wǒmen huì jìnlì lái dádào shìjiè shuǐpíng	We’ll do all we can to catch up the world level.	2.714
我们的身体需要充足的营养。	wǒmen de shēntǐ xūyào chōngzú de yíngyǎng	Our bodies need adequate nutrition.	2.714
跟他在一起的那个女人究竟是谁？	gēn tā zàiyīqǐ de nàge nǚrén jiūjìng shì shéi	Who on earth is that female he’s with?	2.727
她的英雄事迹和她的先进思想是一致的。	tā de yīngxióng shìjì hé tā de xiānjìn sīxiǎng shì yīzhì de	Her heroic deeds sorted well with her advanced thinking.	2.727
劳驾，您能告诉我在哪能买到邮票吗？	láojià nín néng gàosu wǒ zài nǎ néng mǎi dào yóupiào ma	Excuse me, can you tell where to get stamp?	2.727
仍有许多人的生活条件是很艰苦的。	réng yǒu xǔduō rén de shēnghuó tiáojiàn shì hěn jiānkǔ de	There are still many people whose living conditions are miserable.	2.727
我总觉得他讨厌我，但我不知道为什么。	wǒ zǒng juéde tā tǎoyàn wǒ dàn wǒ bù zhīdào wèishénme	I always feel he has a grudge against me, although I don’t know why.	2.727
我已经在这家旅馆里住了两个星期了。	wǒ yǐjīng zài zhè jiā lǚguǎn lǐ zhù le liǎng gè xīngqī le	I have been resident in this hotel for two weeks.	2.727
你决不会知道你的鼓励对我多么有意义。	nǐ jué bùhuì zhīdào nǐ de gǔlì duì wǒ duōme yǒuyìyì	You will never know how much your encouragement meant to me.	2.727
我儿子生病时，丈夫给了我极大的安慰。	wǒ érzi shēngbìng shí zhàngfu gěi le wǒ jídà de ānwèi	My husband was a great comfort to me when my son was ill.	2.727
我上来取我的手提袋，我把它忘在我的办公室了。	wǒ shànglái qǔ wǒ de shǒutí dài wǒ bǎ tā wàng zài wǒ de bàngōngshì le	I’ve come up for my bag, I left it in my office.	2.733
他年近四十。	tā nián jìn sìshí	He is near forty.	2.75
你得等一等看。	nǐ dé děngyīděng kàn	You will have to wait and see.	2.75
那匹马踢了我。	nà pǐ mǎ tī le wǒ	That horse kicked me.	2.75
我正要找你。	wǒ zhèngyào zhǎo nǐ	Just the man I was looking for.	2.75
出国要多少钱？	chūguó yào duōshao qián	How much does it cost to go abroad?	2.75
我坐在他旁边。	wǒ zuò zài tā pángbiān	I sat by his side.	2.75
他得了肺炎。	tā déle fèiyán	He has an inflammation of the lungs.	2.75
她向我眨眼。	tā xiàng wǒ zhǎyǎn	She winked at me.	2.75
她正在闹别扭呢。	tā zhèngzài nàobièniu ne	She is just being difficult.	2.75
现在到了紧要关头。	xiànzài dàoliǎo jǐnyàoguāntóu	We have come to the critical moment.	2.75
他得了肝癌。	tā déle gān’ái	He’s got a cancer in his liver.	2.75
我可以中途下车吗？	wǒ kěyǐ zhōngtú xiàchē ma	Can I make a stop- over on the way?	2.75
她的裙子有非常精致的花边。	tā de qúnzi yǒu fēicháng jīngzhì de huābiān	Her skirt has very exquisite lace.	2.75
搬运工会把你的行李搬到你的房间去的。	bānyùn gōnghuì bǎ nǐ de xíngli bān dào nǐ de fángjiān qù de	The porter will carry your luggage to your room.	2.75
我们家的猫一窝养了4只小猫。	wǒmen jiāde māo yī wō yǎng le zhǐ xiǎomāo	Our cat has a litter of four kittens.	2.75
你们认为他是个好干部吗？	nǐmen rènwéi tā shì gè hǎo gànbù ma	Do you think him a good cadre?	2.75
他的家在这个城市的东北部。	tā de jiā zài zhège chéngshì de dōng běibù	His house is in the northeast of this city.	2.75
在这种地方保密是不可能的。	zài zhèzhǒng dìfang bǎomì shì bùkěnéng de	In this place privacy is impossible.	2.75
大部分有学问的人都很谦虚。	dàbùfen yǒuxuéwèn de rén dōu hěn qiānxū	Most learned men are modest.	2.75
她写了一本关于巴黎公社的书。	tā xiě le yī běn guānyú Bālí Gōngshè de shū	She wrote a book on the Paris Commune.	2.75
他的行为表明他是可敬的。	tā de xíngwéi biǎomíng tā shì kějìng de	His conduct speaks him honorable.	2.75
她梳头的时候我一直看著她。	tā shūtóu de shíhou wǒ yīzhí kàn zhe tā	I watched her as she combed her hair.	2.75
她的衣服让钉子给钩住了。	tā de yīfu ràng dīngzi gěi gōuzhù le	Her dress caught on a nail.	2.75
他和他妻子葬在一起。	tā hé tā qīzi zàng zàiyīqǐ	He was buried with his wife.	2.75
她将我介绍给她的父母。	tā jiāng wǒ jièshào gěi tā de fùmǔ	She introduced me to her parents.	2.75
他不喜欢自己的宽大的鼻孔。	tā bù xǐhuan zìjǐ de kuāndà de bíkǒng	He dislikes his wide nostrils.	2.75
她用挖苦的语调和他说话。	tā yòng wākǔ de yǔ tiáohé tā shuōhuà	She talked with him with sarcastic tones.	2.75
他向每一个愿意听的人抱怨他的不幸。	tā xiàng měiyī gè yuànyì tīng de rén bàoyuàn tā de bùxìng	He moaned about his misfortunes to anyone who would listen.	2.75
你吃了这片药神经就不那麽紧张了。	nǐ chī le zhè piàn yào shénjīng jiù bù nàme jǐnzhāng le	This pill will help to settle your nerves.	2.75
不是我的错。	bùshì wǒ de cuò	It’s not my fault.	2.75
我这就上路。	wǒ zhè jiù shànglù	I’m on my way.	2.75
她千方百计想离开。	tā qiānfāngbǎijì xiǎng líkāi	She made every attempt to go.	2.75
他去年入党了。	tā qùnián rùdǎng le	He was admitted to the Party last year.	2.75
你们在舞会上玩得高兴吗？	nǐmen zài wǔhuì shàng wán dé gāoxìng ma	How did you enjoy the ball?	2.75
她谈的是计算机软件的开发问题。	tā tán de shì jìsuànjī ruǎnjiàn de kāifā wèntí	Her talk ran on developments in computer software.	2.75
您想让我现在开饭吗？	nín xiǎng ràng wǒ xiànzài kāifàn ma	Do you wish me to serve dinner now?	2.75
鱼做得恰到好处。	yú zuò dé qiàdàohǎochù	The fish is done to a turn.	2.75
他被拘留了。	tā bèi jūliú le	He is under arrest.	2.75
每个人都有自己的名字。	měigerén dōu yǒu zìjǐ de míngzi	Each man has his own name.	2.75
她的秘书处理她的一切约会。	tā de mìshū chǔlǐ tā de yīqiè yuēhuì	Her secretary took care of all her appointments.	2.75
上个礼拜我还看到你哥哥。	shàngge lǐbài wǒ hái kàn dào nǐ gēge	I saw your brother as late as last week.	2.75
他不仅请我进屋，而且竟然还请喝了一杯。	tā bùjǐn qǐng wǒ jìn wū érqiě jìngrán hái qǐng hē le yī bēi	He not only invited me into his house but he actually offered me a drink.	2.75
请您放心，还款是有保障的。	qǐng nín fàngxīn huánkuǎn shì yǒu bǎozhàng de	Please rest assured that repayment is ensured.	2.75
他正在上初中。	tā zhèngzài shàng chūzhōng	He is studying at a junior middle school.	2.75
我们的船逆流而上。	wǒmen de chuán nìliú ér shàng	Our ship stemmed on against the current.	2.75
我们都被他的爱国精神深深感动了。	wǒmen dōu bèi tā de àiguó jīngshén shēnshēn gǎndòng le	We are all deeply moved by his patriotism.	2.75
她列举她所要干的事情。	tā lièjǔ tā suǒ yào gàn de shìqing	She listed all the thing she have to do.	2.75
你懂挪威语吗？	nǐ dǒng Nuówēi yǔ ma	Do you know Norwegian?	2.75
爱情是盲目的。	àiqíng shì máng mùdì	Love is blind.	2.75
他似乎是个万事通。其实他是再愚蠢不过了。	tā sìhū shì gè wànshìtōng qíshí tā shì zài yúchǔn bùguò le	It seems as if he knew everything, but in reality, he is as stupid as can be.	2.75
他总是在埋怨。	tā zǒngshì zài mányuàn	He is forever complaining.	2.75
他的建议被认为是切实可行的。	tā de jiànyì bèi rènwéi shì qièshíkěxíng de	His proposal is thought of as practical.	2.75
我喜欢读一些关于电子音乐的书。	wǒ xǐhuan dú yīxiē guānyú diànzǐ yīnyuè de shū	I like to read books on electronic music.	2.75
他完全是胡说！	tā wánquán shì húshuō	What utter rubbish he talks！	2.75
他的财产被他叔叔霸占了。	tā de cáichǎn bèi tā shūshu bàzhàn le	His property was seized on by his uncle.	2.75
成功和财富改变了他的性格。	chénggōng hé cáifù gǎibiàn le tā de xìnggé	Success and wealth transformed his character.	2.75
既然现在她在法国工作，那就可以满足她游览欧洲的愿望了。	jìrán xiànzài tā zài Fǎguó gōngzuò nà jiù kěyǐ mǎnzú tā yóulǎn Ōuzhōu de yuànwàng le	Now that she has a job in France she can gratify her desire to see Europe.	2.75
她喜欢各种运动。	tā xǐhuan gèzhǒng yùndòng	She likes all kinds of sports.	2.75
我是为那个老人女儿的缘故才照顾他的。	wǒ shì wéi nàge lǎorén nǚ’ér de yuángù cái zhàogu tā de	I went to look after the old man on the score of his daughter.	2.75
把你们的名字写在名单上。	bǎ nǐmen de míngzi xiě zài míngdān shàng	Stick down your names on the list.	2.75
解放使我们的生活有了保障。	jiěfàng shǐ wǒmen de shēnghuó yǒule bǎozhàng	Liberation brought security to us.	2.75
我们发现可折叠的桌子使用非常方便。	wǒmen fāxiàn kě zhédié de zhuōzi shǐyòng fēicháng fāngbiàn	We find our folding table a great convenience.	2.75
我将打电话告诉你测验的结果。	wǒ jiāng dǎdiànhuà gàosu nǐ cèyàn de jiéguǒ	I’ll phone the result of the test to you.	2.75
我们在黑暗中摸索。	wǒmen zài hēi’àn zhōng mōsuo	We groped amid the darkness.	2.75
我们决定为我们的新产品做广告。	wǒmen juédìng wéi wǒmen de xīnchǎnpǐn zuò guǎnggào	We decided to advertise our new product.	2.75
她花起钱来大手大脚了，事情很明显，钱是偷来的。	tā huā qǐ qián lái dàshǒudàjiǎo le shìqing hěn míngxiǎn qián shì tōu lái de	She’d begun spending a lot of money, and the obvious inference was that she’d stolen it.	2.769
我们一起欢度的那个晚上是我最快乐的事情之一。	wǒmen yīqǐ huāndù de nàge wǎnshang shì wǒ zuì kuàilè de shìqing zhīyī	That evening together is one of my happiest recollections.	2.769
一般人也许会嘲笑他的音乐，但我们更了解它。	yībānrén yěxǔ huì cháoxiào tā de yīnyuè dàn wǒmen gèng liǎojiě tā	The multitude may laugh at his music, but we know better.	2.769
不论你在哪里，我都会想念你。	bùlùn nǐ zài nǎlǐ wǒ dūhuì xiǎngniàn nǐ	Wherever you are, I will miss you.	2.778
她非常文雅，吃蛋糕一定用小叉子。	tā fēicháng wényǎ chī dàngāo yīdìng yòng xiǎo chāzi	She’s so refined that she always eats cake with a little fork.	2.778
虽然汤药很苦，我还是不得不喝了。	suīrán tāngyào hěn kǔ wǒ háishi bùdébù hē le	I had to take the herb tea although it’s bitter.	2.778
如果我现在不走，就赶不上火车了。	rúguǒ wǒ xiànzài bù zǒu jiù gǎnbùshàng huǒchē le	If I don’t go now, I will miss the train.	2.778
他在同事中受到的评价很高。	tā zài tóngshì zhōng shòudào de píngjià hěn gāo	He is highly estimated among his colleagues.	2.778
他没完没了的谈话妨碍了我的学习。	tā méiwánméiliǎo de tánhuà fáng’ài le wǒ de xuéxí	His endless talking hinders me from my study.	2.778
我怎样才能使你相信我的诚意呢？	wǒ zěnyàng cáinéng shǐ nǐ xiāngxìn wǒ de chéngyì ne	How can I persuade you of my sincerity！	2.778
他在很亮的阳光下眯起了眼睛。	tā zài hěn liàng de yángguāng xià mī qǐ le yǎnjing	He squinted in the bright sunlight.	2.778
现在终于发现，是他偷了那笔钱。	xiànzài zhōngyú fāxiàn shì tā tōu le nà bǐ qián	It has emerged that he stole the money.	2.778
如果有机会，我将去看那部电影。	rúguǒ yǒu jīhuì wǒ jiāng qù kàn nà bù diànyǐng	I will go to see the film if I get the opportunity.	2.778
谁也不怀疑她能胜任教师工作。	shéi yě bù huáiyí tā néng shèngrèn jiàoshī gōngzuò	No one doubts her competence as a teacher.	2.778
他的辞职引起了相当大的轰动。	tā de cízhí yǐnqǐ le xiāngdāng dà de hōngdòng	His resignation made/caused/created quite a stir.	2.778
这个学生总是问他老师一连串的问题。	zhège xuésheng zǒngshì wèn tā lǎoshī yīliánchuàn de wèntí	The student always asks his teacher a series of questions.	2.778
她意外地发现了他的真实身份。	tā yìwài dì fāxiàn le tā de zhēnshí shēnfèn	She stumbled on his true identity.	2.778
在我们家里，丈夫和我都挣工资。	zài wǒmen jiālǐ zhàngfu hé wǒ dōu zhèng gōngzī	In our family both my husband and I are wage earners.	2.778
我答应一定完好无损地还你的自行车。	wǒ dāying yīdìng wánhǎowúsǔn dì hái nǐ de zìxíngchē	I promise to return your bicycle on good condition.	2.778
我们今后一星期没有见面的机会了。	wǒmen jīnhòu yī xīngqī méiyǒu jiànmiàn de jīhuì le	We have no chance to meet each other a week hence.	2.778
她的眼睛里闪耀出激动的神色。	tā de yǎnjing lǐ shǎnyào chū jīdòng de shénsè	Her eyes kindled with excitement.	2.778
该是你认识形势的真实情况的时候了。	gāi shì nǐ rènshi xíngshì de zhēnshí qíngkuàng de shíhou le	It’s time you awake to the realities of the situation.	2.778
我要去购物，因为我需要买些日用品。	wǒ yào qù gòuwù yīnwèi wǒ xūyào mǎi xiē rìyòngpǐn	I’m going shopping because I need to buy some daily necessities.	2.778
他的父母并不像他的老师对他那样有影响。	tā de fùmǔ bìngbù xiàng tā de lǎoshī duì tā nàyàng yǒuyǐngxiǎng	It is not his parents that influence him so much as his teachers.	2.786
他最初的反应是不同意。可是後来他改变了主意。	tā zuìchū de fǎnyìng shì bùtóng yì kěshì hòu lái tā gǎibiàn le zhǔyi	His first response was to say no. Later, however, he changed his mind.	2.786
模糊的不清楚的或者不明显的；含糊的或者朦胧的	móhu de bùqīngchu de huòzhě bù míngxiǎn de hánhú de huòzhě ménglóng de	Lacking clarity or distinctness; cloudy or obscure.	2.786
想到我们把所有的钱都花在儿子的教育上，而他却所想去一家沉闷的工厂工作，我感到很伤心。	xiǎngdào wǒmen bǎ suǒyǒu de qián dōu huā zài érzi de jiàoyù shàng ér tā què suǒxiǎng qù yījiā chénmèn de gōngchǎng gōngzuò wǒ gǎndào hěn shāngxīn	It breads my heart to think of all the money we spent on our son’s education and all he wants to do is work in a dreary factory.	2.786
他爷爷快七十岁了。	tā yéye kuài qīshí suì le	His grandfather is nearly seventy.	2.8
酸是有腐蚀性的。	suān shì yǒu fǔshí xìng de	Acid is corrosive.	2.8
啤酒走了气了。	píjiǔ zǒu le qì le	The beer is stale.	2.8
你会说什么语言？	nǐ huì shuō shénme yǔyán	What languages can you speak?	2.8
我不敢去想她知道真相后会怎么样。	wǒ bù gǎn qù xiǎng tā zhīdào zhēnxiàng hòu huì zěnmeyàng	I dread to think what will happen if she finds out the truth.	2.8
你的这一班机是英国航空公司的飞机。	nǐ de zhè yī bānjī shì Yīngguó hángkōnggōngsī de fēijī	Your carrier for this flight is British Airways.	2.8
把这本书给她。	bǎ zhè běn shū gěi tā	Give her the book.	2.8
这本书是他以前写的剧本的扩充。	zhè běn shū shì tā yǐqián xiě de jùběn de kuòchōng	This book is an expansion of the play he wrote before.	2.8
我一走近她的办公桌，她就瞪我。	wǒ yī zǒu jìn tā de bàngōng zhuō tā jiù dèng wǒ	She glares at me if I go near her desk.	2.8
我一直在四处寻找它。	wǒ yīzhí zài sìchù xúnzhǎo tā	I have been seeking it all round.	2.8
这顿饭我请客，你把钱收起来吧。	zhè dùn fàn wǒ qǐngkè nǐ bǎ qián shōu qilai ba	This meal is my treat, so put your money away.	2.8
他的梦想实现了。	tā de mèngxiǎng shíxiàn le	His dream came true.	2.8
他骑马去森林了。	tā qímǎ qù sēnlín le	He went to the forest on horseback.	2.8
她同情他的困苦。	tā tóngqíng tā de kùnkǔ	She sympathized with him in his afflictions.	2.8
鳝鱼的味道很好。	shànyú de wèidao hěn hǎo	The taste of eel is delicious.	2.8
不值得我去乞求	bùzhíde wǒ qù qǐqiú	It was beneath me to beg.	2.8
他通常是忙碌的。	tā tōngcháng shì mánglù de	He is usually busy.	2.8
在我祖父看来，我爸爸仍然是个小孩。	zài wǒ zǔfù kànlai wǒ bàba réngrán shì gè xiǎohái	It seems to my grandfather that my father is still a child.	2.8
他贿赂他的领导来巩固他的地位。	tā huìlù tā de lǐngdǎo lái gǒnggù tā de dìwèi	He bribes his leader to consolidate his position.	2.8
我今天的心情不好。	wǒ jīntiān de xīnqíng bùhǎo	I’m feeling blue today.	2.8
由此可见，你是对的。	yóucǐkějiàn nǐ shì duì de	On the face of it, you are right.	2.8
我的眼镜框断了！	wǒ de yǎnjìng kuàng duàn le	My eyeglass frame is broken！	2.8
这件衣服不适合我。	zhè jiàn yīfu bù shìhé wǒ	This dress doesn’t fit me.	2.8
我确实很好，谢谢您。	wǒ quèshí hěn hǎo xièxie nín	I’m very well indeed, thank you.	2.8
这到底是什么？	zhè dàodǐ shì shénme	What on earth is that?	2.8
我最害怕他发怒。	wǒ zuì hàipà tā fānù	I fear his wrath more than anything.	2.8
他的体重在增加。	tā de tǐzhòng zài zēngjiā	He’s putting on weight.	2.8
喜讯传来，他心情很好。	xǐxùn chuánlái tā xīnqíng hěn hǎo	The good news put him in fine fettle.	2.8
随地吐痰是不允许的。	suídì tǔtán shì bù yǔnxǔ de	It’s not allowed to spit everywhere.	2.8
老是有各种各样的天气，不论我们喜欢不喜欢。	lǎoshi yǒu gèzhǒnggèyàng de tiānqì bùlùn wǒmen xǐhuan bù xǐhuan	There’s always weather, weather, whether we like it or not.	2.8
那是胜利的预兆。	nàshi shènglì de yùzhào	It’s an omen of victory.	2.8
他的专业是比较文学。	tā de zhuānyè shì bǐjiàowénxué	He majored in comparative literature.	2.8
无论如何，我都支持你。	wúlùnrúhé wǒ dōu zhīchí nǐ	I’ll stand by you whatever happens.	2.8
用功的学生有前途。	yònggōng de xuésheng yǒu qiántú	Promising is a diligent student.	2.8
我目前的这一切额外工作用去了我的闲暇时间。	wǒ mùqián de zhè yīqiè éwài gōngzuò yòng qù le wǒ de xiánxiá shíjiān	All this extra work I’m doing is breaking into my leisure time.	2.8
请把我的信件转到我的新地址。	qǐng bǎ wǒ de xìnjiàn zhuàn dào wǒ de xīn dìzhǐ	Please forward my mail to my new address.	2.8
空想的想象的；不真实的；爱空想的	kōngxiǎng de xiǎngxiàng de bù zhēnshí de ài kōngxiǎng de	Imaginary; unreal; fanciful.	2.8
把它记在我的信用卡的帐号里。	bǎ tā jì zài wǒ de xìnyòngkǎ de zhànghào lǐ	Have it charged to my credit card.	2.8
我把钥匙掉在这附近某个地方了。	wǒ bǎ yàoshi diào zài zhè fùjìn mǒu gè dìfang le	I dropped my key somewhere about here.	2.8
你的名字已登记在选民名册上了吗？	nǐ de míngzi yǐ dēngjì zài xuǎnmín míngcè shàng le ma	Have you got your name on the electoral register?	2.8
我不知道该怎样来感谢你才好。	wǒ bù zhīdào gāi zěnyàng lái gǎnxiè nǐ cái hǎo	I don’t know how I can possibly thank you enough.	2.8
他站起身给自己又倒了点咖啡。	tā zhàn qǐshēn gěi zìjǐ yòu dǎo le diǎn kāfēi	He got up and helped himself to more coffee.	2.8
有了它真是方便。	yǒule tā zhēnshi fāngbiàn	It really comes in handy.	2.8
她耸了耸肩就离开了。	tā sǒng le sǒngjiān jiù líkāi le	She gave a shrug and walked away.	2.8
瓶子里装满了水。	píngzi lǐ zhuāngmǎn le shuǐ	The bottle is full of water.	2.8
你永远应该以搞好你的工作为目的。	nǐ yǒngyuǎn yīnggāi yǐ gǎohǎo nǐ de gōngzuò wéi mùdì	You should always aim at doing your job well.	2.8
熊猫是珍贵的动物。	xióngmāo shì zhēnguì de dòngwù	Pandas are precious creatures.	2.8
我们的产品在国内市场上都很畅销。	wǒmen de chǎnpǐn zài guónèi shìchǎng Shàngdū hěn chàngxiāo	Our product command a good market both at home and abroad.	2.8
她讲了一辈子中文。	tā jiǎng le yībèizi Zhōngwén	She has spoken Chinese all her life.	2.8
他展开报纸开始阅读。	tā zhǎnkāi bàozhǐ kāishǐ yuèdú	He unfurled the newspaper and began to read.	2.8
房间里挤满了客人。	fángjiān lǐ jǐmǎn le kèrén	The room was crowded with guests.	2.8
思考正确是重要的。	sīkǎo zhèngquè shì zhòngyào de	Thinking correctly is important.	2.8
我们的地位可以改善。	wǒmen de dìwèi kěyǐ gǎishàn	Our position is capable of improvement.	2.8
由于下雨，取消了比赛。	yóuyú xiàyǔ qǔxiāo le bǐsài	Owing to the rain, the match was cancelled.	2.8
使兴奋的使人精力充沛的；使兴奋的	shǐxīngfèn de shǐ rén jīnglìchōngpèi de shǐxīngfèn de	Serving to invigorate; stimulating.	2.8
明天上午行吗？	míngtiān shàngwǔ xíng ma	Is tomorrow morning any good?	2.8
他在社会福利部工作。	tā zài shèhuì fúlì bù gōngzuò	He worked in community welfare department.	2.8
他害怕得声音发抖。	tā hàipà dé shēngyīn fādǒu	His voice shook with fear.	2.8
我的计划逐渐成熟。	wǒ de jìhuà zhújiàn chéngshú	My plan has gradually come to maturity.	2.8
情况始终都在变化。	qíngkuàng shǐzhōng dōu zài biànhuà	Conditions are changing all the time.	2.8
后面那辆车想超过我们。	hòumian nà liàng chē xiǎng chāoguò wǒmen	The car behind wants to get ahead of us.	2.8
多亏您们的帮助，我们才成功完成了工作。	duōkuī nín men de bāngzhù wǒmen cái chénggōng wánchéng le gōngzuò	Owing to you help, we have just successfully completed work.	2.8
我们什么时候会面合适？	wǒmen shénmeshíhou huìmiàn héshì	What time is suitable for us to meet?	2.8
爱邻居犹如爱自己。	ài línjū yóurú ài zìjǐ	Love your neighbors as yourself.	2.8
他们的狗把我的裤子咬了个窟窿。	tāmen de gǒu bǎ wǒ de kùzi yǎo le gè kūlong	Their dog bit a hole in my trousers.	2.818
你能把那一点指出来，我感到很高兴。	nǐ néng bǎ nà yīdiǎn zhǐchū lái wǒ gǎndào hěn gāoxìng	I’m glad you raised that point.	2.818
我发现有人用过我的牙刷，我很不高兴。	wǒ fāxiàn yǒurén yòng guò wǒ de yáshuā wǒ hěn bù gāoxìng	I am aggrieved to find that someone has used my toothbrush.	2.818
我不知道这个对你的意义有这么大。	wǒ bù zhīdào zhège duì nǐ de yìyì yǒu zhème dà	I didn’t realize how much this meant to you.	2.818
他的时间排得很满，学生根本无法和他接触。	tā de shíjiān pái dehěn mǎn xuésheng gēnběn wúfǎ hé tā jiēchù	His busy schedule made him completely inaccessible to his students.	2.818
我的女儿十八岁了，已经长成为美丽的淑女。	wǒ de nǚ’ér shíbā suì le yǐjīng cháng chéngwéi měilì de shūnǚ	My daughter is eighteen years old and has grown into a beautiful lady.	2.818
这家公司的主要问题是缺少有技术的人员。	zhè jiā gōngsī de zhǔyào wèntí shì quē shǎoyǒu jìshù de rényuán	The company’s main problem is the shortage of skilled personnel.	2.818
你一定会被那美丽的景象所感动的。	nǐ yīdìng huì bèi nà měilì de jǐngxiàng suǒ gǎndòng de	You will never fail to be moved by the beauty of the sight.	2.818
他答应赶紧写好报告，今天就给我们送来。	tā dāying gǎnjǐn xiě hǎo bàogào jīntiān jiù gěi wǒmen sòng lái	He promised to hurry on with the report and send it to us today.	2.818
多亏许多科学的工作，我们能预先知道要发生地震的时间和地点了。	duōkuī xǔduō kēxué de gōngzuò wǒmen néng yùxiān zhīdào yào fāshēng dìzhèn de shíjiān hé dìdiǎn le	Thanks to the work of many scientists, we are able to learn in advance when and where an earthquake will happen.	2.824
我看穿了他的阴谋。	wǒ kànchuān le tā de yīnmóu	I saw through his plot.	2.833
五加三的总和是八。	wǔ jiā sān de zǒnghé shì bā	The sum of 5 and 3 is 8.	2.833
她是个古怪的老太太。	tā shì gè gǔguài de lǎotàitai	She is an eccentric old lady.	2.833
那衣服太昂贵，我买不起。	nà yīfu tài ángguì wǒ mǎibuqǐ	The dress is too expensive for me to buy.	2.833
他的忠诚是可信的。	tā de zhōngchéng shì kěxìn de	His faithfulness can be trusted.	2.833
她的记性很好。	tā de jìxìng hěn hǎo	She has a good memory.	2.833
她的聪颖是不言而喻的。	tā de cōngyǐng shì bùyán’éryù de	Her intelligence is self-evident.	2.833
你不喜欢那座亭子吗？	nǐ bù xǐhuan nà zuò tíngzi ma	Do not you love that pavilion?	2.833
人是有理性的生物。	rén shì yǒu lǐxìng de shēngwù	Man is a rational being.	2.833
她是个守法的公民。	tā shì gè shǒufǎ de gōngmín	She is a lawful citizen.	2.833
她推说她觉得很疲劳。	tā tuīshuō tā juéde hěn píláo	She pleaded that she felt very tired.	2.833
请你把这颗纽扣缝到我的衬衫上好吗？	qǐng nǐ bǎ zhè kē niǔkòu féng dào wǒ de chènshān shànghǎo ma	Would you sew this button onto my shirt?	2.833
亲爱的，把脸转过去，这场面不适合你看。	qīn’ài de bǎ liǎn zhuàn guòqu zhè chǎngmiàn bù shìhé nǐ kàn	Look away dear, the sight is not fit for your eyes.	2.833
他找了个站不住脚的理由来解释缺席的原因。	tā zhǎo le gè zhànbuzhùjiǎo de lǐyóu lái jiěshì quēxí de yuányīn	He gave a lame excuse for being absent.	2.833
哲琪太太：嗯，坦白说，我不很好，小姐。今天早上我的狗被一辆车撞了。	zhé qí tàitai èn tǎnbái shuō wǒ bùhěn hǎo xiǎojie jīntiān zǎoshang wǒ de gǒu bèi yī liàng chē zhuàng le	Mrs. Jerky: Well, to be quite frank, I’m not so hot, young lady. This morning, my dog got hit by a car.	2.833
惯常想知道自己的孩子在哪里的旧式母亲，如今有了个想知道自己的母亲在哪里的孙子。	guàncháng xiǎng zhīdào zìjǐ de háizi zài nǎlǐ de jiùshì mǔqīn rújīn yǒule gè xiǎng zhīdào zìjǐ de mǔqīn zài nǎlǐ de sūnzi	The old-time mother who used to wonder where her boy was now has a grandson who wonders where his mother is.	2.833
他不是出卖我们的人。	tā bùshì chūmài wǒmen de rén	He is not the man selling us.	2.833
她这个人不好说话，我想她不会答应我们的。	tā zhè gèrén bùhǎo shuōhuà wǒ xiǎng tā bùhuì dāying wǒmen de	She is a hard nut(to crack);I don’t think she will give us permission.	2.833
我八点钟就到医院了，但是九点钟我才去值班。	wǒ bā diǎnzhōng jiù dào yīyuàn le dànshì jiǔ diǎnzhōng wǒ cái qù zhíbān	I arrive at the hospital at eight o’clock, but I don’t go on duty until nine.	2.833
他的诗集去年发表了。	tā de shījí qùnián fābiǎo le	His poetry was published last year.	2.833
这不过是个笑话而已。	zhè bùguò shì gè xiàohuà éryǐ	It is nothing but a joke.	2.833
我百分之百同意你的看法。	wǒ bǎifēnzhībǎi tóngyì nǐ de kànfǎ	I am a hundred percent in agreement with you.	2.833
我们班的学生比他们班的那些更不积极。	wǒmen bān de xuésheng bǐ tāmen bān de nàxiē gèng bù jījí	The student of our class is not positively than those of their class.	2.833
针刺进了她的手指。	zhēncì jìn le tā de shǒuzhǐ	The needle pierced her finger.	2.833
她的心脏还在跳动。	tā de xīnzàng hái zài tiàodòng	Her heart was still beating.	2.833
我指望你来安排一切。	wǒ zhǐwàng nǐ lái ānpái yīqiè	I am banking upon you to help me with arrangements.	2.833
她显得很不好意思的样子。	tā xiǎnde hěn bùhǎoyìsi de yàngzi	She looked very embarrassed.	2.833
他老是打扰我。	tā lǎoshi dǎrǎo wǒ	He’s constantly disturbing me.	2.833
尽管我知道菠菜对我有益，我还是不喜欢它、	jǐnguǎn wǒ zhīdào bōcài duì wǒ yǒuyì wǒ háishi bù xǐhuan tā	I do not like spinach even though I know it’s good for me.	2.833
他对他的选民表现出很有感染力的热情。	tā duì tā de xuǎnmín biǎoxiàn chū hěn yǒu gǎnrǎnlì de rèqíng	He expressed infectious enthusiasm to his voters.	2.833
我不好意思告诉她我不及格。	wǒ bùhǎoyìsi gàosu tā wǒ bùjígé	I was too ashamed to tell her that I had failed.	2.833
他的决心开始动摇了	tā de juéxīn kāishǐ dòngyáo le	His resolve began to waver.	2.833
他写的文章尖锐深刻。	tā xiě de wénzhāng jiānruì shēnkè	He writes with penetration.	2.833
嗯，但是你必须等我。	èn dànshì nǐ bìxū děng wǒ	Mmm, but you must wait for me.	2.833
我给我儿子买了为儿童改编的莎士比亚剧本。	wǒ gěi wǒ érzi mǎi le wéi értóng gǎibiān de Shāshìbǐyà jùběn	I bought my son an adaptation for children of a play by Shakespeare.	2.833
她即使在最糟糕的时候也总是非常乐观。	tā jíshǐ zài zuì zāogāo de shíhou yě zǒngshì fēicháng lèguān	She was always optimistic, even when things were at their worst.	2.833
在我们的菜园里，我们种了茄子，黄瓜和土豆。	zài wǒmen de càiyuán lǐ wǒmen zhǒng le qiézi huángguā hé tǔdòu	In our garden we have egg-plants, cucumber and potato.	2.833
他把所有的时间都用在做纵横填字游戏和其他无聊的活动上。	tā bǎ suǒyǒu de shíjiān dōu yòng zài zuò zònghéng tián zì yóuxì hé qítā wúliáo de huódòng shàng	He spends all his time on crosswords and other trifles.	2.833
我们做了非正式的会晤。	wǒmen zuò le fēizhèngshì de huìwù	We had an informal meeting.	2.833
请做这个句子的填空。	qǐng zuò zhège jùzi de tiánkòng	Please fill in the blanks in the sentence.	2.833
那恰好符合我们的需要。	nà qiàhǎo fúhé wǒmen de xūyào	That answers precisely to our need.	2.833
他沉思着过去的生活。	tā chénsī zhe guòqu de shēnghuó	He meditates on his past life.	2.833
他愉快地跟我们打招呼。	tā yúkuài dì gēn wǒmen dǎzhāohu	He gave us a cheery greeting.	2.833
据说我们的祖先是猴子。	jùshuō wǒmen de zǔxiān shì hóuzi	It is said that our progenitors are monkeys.	2.833
领导做了英明的决定。	lǐngdǎo zuò le yīngmíng de juédìng	The leader made a sagacious decision.	2.833
老师以嘶哑的声音说话。	lǎoshī yǐ sīyǎ de shēngyīn shuōhuà	The teacher speaks with a husky voice.	2.833
他真心诚意地愿意帮助我们。	tā zhēnxīn chéngyì dì yuànyì bāngzhù wǒmen	He has a genuine desire to help us.	2.833
工作完成了--好倒是好--但是答应给我们的奖金给不给？	gōngzuò wánchéng le hǎo dàoshi hǎo dànshì dāying gěi wǒmen de jiǎngjīn gěi bù gěi	The job’s done, that’s all well and good but what about the bonus we were promised?	2.842
即使多年没有看见我的同学，我也马上认出了他。	jíshǐ duō nián méiyǒu kànjiàn wǒ de tóngxué wǒ yě mǎshàng rènchū le tā	Even though I hadn’t seen my classmate for many years, I recognized him immediately.	2.846
请站到一边，你的影子计划遮住了他的活儿。	qǐng zhàn dào yībiān nǐ de yǐngzi jìhuà zhēzhù le tā de huór	Please stand to one side, you’re casting your shadow over his work.	2.846
我的铅笔钝了，你能借我把刀子削一削吗？	wǒ de qiānbǐ dùn le nǐ néng jiè wǒ bǎ dāozi xiāo yī xiāo ma	My pencil is blunt, could you lend me a knife to sharpen it?	2.846
刘师傅把每道工序做给我们看，然后让我们自己干。	Liú shīfu bǎ měi dào gōngxù zuò gěi wǒmen kàn ránhòu ràng wǒmen zìjǐ gàn	Master Liu demonstrated to us each process, and let us do it ourselves.	2.846
你和你姐姐都这么说。	nǐ hé nǐ jiějie dōu zhème shuō	You and your sister said so yourselves.	2.857
真是的，这叫人非常不便。	zhēnshide zhè jiào rén fēicháng bùbiàn	Well, this is most inconvenient.	2.857
我给他买了一袋糖果。	wǒ gěi tā mǎi le yī dài tángguǒ	I bought him a packet of sugar.	2.857
他给她叫了一辆出租汽车。	tā gěi tā jiào le yī liàng chūzūqìchē	He called her a taxi.	2.857
狄更斯是他最喜欢的作家、	Dígēngsī shì tā zuì xǐhuan de zuòjiā	Dickens is his favorite author.	2.857
你能帮我一个忙吗？	nǐ néng bāng wǒ yī gè máng ma	Would you do me a favor?	2.857
请原谅我的字写得不好。	qǐng yuánliàng wǒ de zì xiě dé bùhǎo	Please excuse my bad handwriting.	2.857
每个男人都有他的用处，每个女人都有她的藉口。	měi gè nánrén dōu yǒu tā de yòngchu měi gè nǚrén dōu yǒu tā de jièkǒu	Every man has his uses, and every woman her excuses.	2.857
所有的灯都闪了一会儿。	suǒyǒu de dēng dōu shǎn le yīhuìr	All the lights flickered for a moment.	2.857
别为我操心，我一切都好。	bié wéi wǒ cāoxīn wǒ yīqiè dōu hǎo	Don’t bother yourself about me; I am doing quite well.	2.857
不论你去不去，请打电话给我。	bùlùn nǐ qù bù qù qǐng dǎdiànhuà gěi wǒ	Whether you will go (or not), please call me up.	2.857
他是一位非常重要的人物。	tā shì yī wèi fēicháng zhòngyào de rénwù	He is a man of great importance.	2.857
她长成了一位漂亮的女人。	tā cháng chéngle yī wèi piàoliang de nǚrén	She developed into a beautiful woman.	2.857
她的卧室里满是画片。	tā de wòshì lǐ mǎn shì huà piàn	Her bedroom is covered with posters.	2.857
他挤到了人群的前面。	tā jǐ dàoliǎo rénqún de qiánmiàn	He pushed his way to the front of the crowd.	2.857
该被责怪的人是你。	gāi bèi zéguài de rén shì nǐ	It is you who are to blame.	2.857
我怎样能跟你联络上？	wǒ zěnyàng néng gēn nǐ liánluò shàng	How can I get in touch with you?	2.857
你知道谁是电灯的发明者？	nǐ zhīdào shéi shì diàndēng de fāmíngzhě	Do you know who is the creator of the electric bulb?	2.857
我们中午能到牛津吗？	wǒmen zhōngwǔ néng dào Niújīn ma	D’you think we’ll make Oxford by midday?	2.857
谁都无法形容这景色的美丽。	shéi dōu wúfǎxíngróng zhè jǐngsè de měilì	There is no describing the beauty of the scene.	2.857
他喜欢在说话中用比喻。	tā xǐhuan zài shuōhuà zhōng yòng bǐyù	He likes to talk in similitude.	2.857
很遗憾要打扰你一下，我想问问我们什么时候能聊聊。	hěn yíhàn yào dǎrǎo nǐ yīxià wǒ xiǎng wèn wèn wǒmen shénmeshíhou néng liáo liáo	I’m sorry to trouble you, but I wondered if we could have a word some time.	2.857
这幅画被他看中了，所以他就把他买了下来。	zhè fú huà bèi tā kànzhòng le suǒyǐ tā jiù bǎ tā mǎi le xiàlai	The painting took his fancy, so he bought it.	2.857
她不把我们的警告放在心上。	tā bù bǎ wǒmen de jǐnggào fàngzàixīnshàng	She paid no heed to our warnings.	2.857
他以他的书法为自豪。	tā yǐ tā de shūfǎ wéi zìháo	He prides himself on his handwriting.	2.857
我对她的工作不太欣赏。	wǒ duì tā de gōngzuò bù tài xīnshǎng	I am not a great admirer of her work.	2.857
他的去世使我们非常悲伤。	tā de qùshì shǐ wǒmen fēicháng bēishāng	His decease made us very sad.	2.857
他干这工作很熟练。	tā gàn zhè gōngzuò hěn shúliàn	He performed the job with practised skill.	2.857
她认为自己懂得什么是生活。	tā rènwéi zìjǐ dǒngde shénme shì shēnghuó	She esteemed that she knew what life was.	2.857
我不知道合同的正确条款。	wǒ bù zhīdào hétong de zhèngquè tiáokuǎn	I don’t know the exact terms of the contract.	2.857
她觉得自己的工作毫无乐趣。	tā juéde zìjǐ de gōngzuò háowú lèqù	She took no pleasure in her work.	2.857
要是你花的比我们挣的还多，我们就要欠债了。	yàoshi nǐ huā de bǐ wǒmen zhèng de hái duō wǒmen jiùyào qiànzhài le	We’ll run into debt if you spend more than our income.	2.857
我们在月光下静静地坐着。	wǒmen zài yuèguāng xià jìng jìng dì zuò zhe	We sat quietly in the moonshine.	2.857
他被树立为我们的榜样。	tā bèi shùlì wéi wǒmen de bǎngyàng	He was set up as our example.	2.857
他对自己的缺点十分清楚。	tā duì zìjǐ de quēdiǎn shífēn qīngchu	He was very conscious of his shortcomings.	2.857
你必须熟悉自己的新职务。	nǐ bìxū shúxī zìjǐ de xīn zhíwù	You must acquaint yourself with your new duties.	2.857
我们的主要问题就是缺少时间。	wǒmen de zhǔyào wèntí jiùshì quēshǎo shíjiān	Our principal problem is lack of time.	2.857
瞧，我这是怎么搞的！它本是辆新车。我怎么办好呢？	qiáo wǒ zhè shì zěnmegǎode tā běn shì liàng xīn chē wǒ zěnmebàn hǎo ne	Just look what I have done！ It was a new car. Whatever am I going to do?	2.867
我可不知道在这地球上有什么东西比七厘利息更无情的。	wǒ kě bù zhīdào zài zhè dìqiú shàng yǒu shénme dōngxi bǐ qī lí lìxī gèng wúqíng de	I do not know of anything more remorseless on the face of the earth than seven per cent interest.	2.867
我们这里的天气多半是暖和的。	wǒmen zhèlǐ de tiānqì duōbàn shì nuǎnhuo de	Our weather has been mostly warm.	2.875
吃饭的时候我坐在他的对面。	chīfàn de shíhou wǒ zuò zài tā de duìmiàn	I sat opposite to him during the meal.	2.875
我喜欢这乡村，尤其是在春天。	wǒ xǐhuan zhè xiāngcūn yóuqíshì zài chūntiān	I love the country, especially in spring.	2.875
我的秘书真是个难能可贵的人。	wǒ de mìshū zhēnshi gè nánnéngkěguì de rén	My secretary is an absolute gem.	2.875
我得修修表，它不走了。	wǒ dé xiū xiū biǎo tā bù zǒu le	I’ll have my watch repaired; it doesn’t work.	2.875
我确信他是个可靠的接班人。	wǒ quèxìn tā shì gè kěkào de jiēbānrén	I am sure that he is a reliable successor.	2.875
他给我看一张合家欢的照片。	tā gěi wǒ kàn yī zhāng héjiāhuān de zhàopiàn	He showed me a photo of a family group.	2.875
她用功的程度是我的三倍。	tā yònggōng de chéngdù shì wǒ de sānbèi	She studies three times as hard as I.	2.875
她一晚上都在批试卷。	tā yī wǎnshang dōu zài pī shìjuàn	She spent the evening marking examination papers.	2.875
是的，我已听说这消息了。	shìde wǒ yǐ tīngshuō zhè xiāoxi le	Yes, I’ve heard about the news.	2.875
你看到火车站对面的房子了吗？	nǐ kàn dào huǒchēzhàn duìmiàn de fángzi le ma	Have you seen the house opposite the railway station?	2.875
我父亲要我送顾客到门口。	wǒ fùqīn yào wǒ sòng gùkè dào ménkǒu	My father asked me to see the customer to the door.	2.875
他给我显示了大厦的模型。	tā gěi wǒ xiǎnshì le dàshà de móxíng	He showed me the miniature of the mansion.	2.875
暖和的天气诱使我放下了学习。	nuǎnhuo de tiānqì yòushǐ wǒ fàngxia le xuéxí	The warm weather seduced me away from my studies.	2.875
坐过去点，让你外婆坐下来。	zuò guòqu diǎn ràng nǐ wàipó zuò xiàlai	Move over and let your grandmother sit down.	2.875
我把这本书从头到尾看完了。	wǒ bǎ zhè běn shū cóngtóudàowěi kàn wán le	I’ve read the book from beginning to end.	2.875
我在他桌上留了张便条。	wǒ zài tā zhuō shàng liú le zhāng biàntiáo	I leave a note on his desk.	2.875
许多新税收都是有争议的。	xǔduō xīn shuìshōu dōu shì yǒu zhēngyì de	Many of the new taxes are controversial.	2.875
把他的名字从名单上划去。	bǎ tā de míngzi cóng míngdān shàng huà qù	Strike his name off the list.	2.875
他宣誓要为他的国家而战。	dǎliè shí tā shè xià yī zhǐ dàdà yàn	He took the oath to fight for his country.	2.875
我必须买一节新的干电池了。	wǒ bìxū mǎi yī jié xīn de gàn diànchí le	I have to buy a new dry cell.	2.875
他的不幸激起了我们的同情。	tā de bùxìng jīqǐ le wǒmen de tóngqíng	His wretchedness aroused our sympathy.	2.875
她的任务是感化过去的罪犯。	tā de rènwu shì gǎnhuà guòqu de zuìfàn	Her mission was to reclaim former criminals.	2.875
老师的说明澄清了困扰的问题。	lǎoshī de shuōmíng chéngqīng le kùnrǎo de wèntí	The teacher’s explanation clarify the puzzling problem.	2.875
活泼的孩子有时是会淘气的。	huópo de háizi yǒushí shì huì táoqì de	One expects active children to be mischievous at times.	2.875
尽管我努力劝说，他还是不同意。	jǐnguǎn wǒ nǔlì quànshuō tā háishi bùtóng yì	In spite of my efforts at persuasion, he wouldn’t agree.	2.875
现在有15分钟的中间休息。	xiànzài yǒu fēnzhōng de zhōngjiān xiūxi	There will now be a 15-minute interlude.	2.875
这条峡谷里的景色非常美丽。	zhè tiáo xiágǔ lǐ de jǐngsè fēicháng měilì	The scene is very beautiful in this glen.	2.875
老师狠狠地瞪了我一眼，所以我怀疑我做错了什么事。	lǎoshī hěnhěn dì dèng le wǒ yīyǎn suǒyǐ wǒ huáiyí wǒ zuòcuò le shénmeshì	The teacher threw a fierce look at me, so I wondered what I had done wrong.	2.875
什么是解决这个问题的最好方法？	shénme shì jiějué zhège wèntí de zuìhǎo fāngfǎ	What’s the best way to tackle this problem?	2.875
西红柿的短缺提高了它的价格。	xīhóngshì de duǎnquē tígāo le tā de jiàgé	The shortage of tomatoes kept the prices up.	2.875
我父亲决不会同意我们的婚姻的。	wǒ fùqīn jué bùhuì tóngyì wǒmen de hūnyīn de	My father will never give his consent to our marriage.	2.875
他的聪明和技巧使我们赞叹不已。	tā de cōngming hé jìqiǎo shǐ wǒmen zàntànbùyǐ	His cleverness and skill compel our admiration.	2.875
他喜欢读伟人传记来提高自己。	tā xǐhuan dú wěirén zhuànjì lái tígāo zìjǐ	He likes to read biographies of great men to promote himself.	2.875
她处理政治问题的方法很科学。	tā chǔlǐ zhèngzhì wèntí de fāngfǎ hěn kēxué	She has a very scientific method of dealing with political problems.	2.875
你应该在课堂上完成语法练习。	nǐ yīnggāi zài kètáng shàng wánchéng yǔfǎ liànxí	You should finish your English grammar drills in the class.	2.875
他的身体被工作压垮了。	tā de shēntǐ bèi gōngzuò yākuǎ le	His health collapsed under the pressure of work.	2.875
他学习日语的兴趣逐渐消失了。	tā xuéxí Rìyǔ de xìngqù zhújiàn xiāoshī le	His interest in learning Japanese has petered out.	2.875
赶快！会议已开始了，我们迟到了。	gǎnkuài huìyì yǐ kāishǐ le wǒmen chí dàoliǎo	Get a move on！ We’re already late for the meeting.	2.875
他的粗鲁惹得我揍了他。	tā de cūlǔ rě dé wǒ zòu le tā	His rudeness provoked me to strike him.	2.889
这只小动物有一双淡褐色的眼睛。	zhè zhǐ xiǎo dòngwù yǒu yī shuāng dàn hèsè de yǎnjing	This small animal has a pair of hazel eyes.	2.889
我的同事已经戒掉了吸烟的习惯。	wǒ de tóngshì yǐjīng jiè diào le xīyān de xíguàn	My colleague has broken off the habit of smoking.	2.889
我的围裙太脏了，我不得不洗它。	wǒ de wéiqún tài zāng le wǒ bùdébù xǐ tā	My apron is so dirty that I have to wash it.	2.889
这热辣辣的太阳快把我烤焦了！	zhè rè là là de tàiyang kuài bǎ wǒ kǎo jiāo le	I am broiling in this hot sun！	2.889
请你把这封信复印一份好吗？	qǐng nǐ bǎ zhè fēng xìn fùyìn yī fèn hǎo ma	Could you Xerox this letter please?	2.889
从他的口音判断，他一定是南方人。	cóng tā de kǒuyin pànduàn tā yīdìng shì nánfāng rén	Judging by his accent, he must be from the South.	2.889
我相信他天生是要当军人的。	wǒ xiāngxìn tā tiānshēng shì yào dāng jūnrén de	I believe he is meant to be a soldier.	2.889
自从他是小孩时，他就喜欢狗。	zìcóng tā shì xiǎohái shí tā jiù xǐhuan gǒu	He has liked dogs since he was a child.	2.889
他请求他母亲答应他去看马戏。	tā qǐngqiú tā mǔqīn dāying tā qù kàn mǎxì	He pleaded with his mother to allow him to go to the circus.	2.889
他的个性体现在他的文章中。	tā de gèxìng tǐ xiànzài tā de wénzhāng zhōng	His personality comes through in his writing.	2.889
今天早晨报上有什么有趣的新闻吗？	jīntiān zǎochén bàoshàng yǒu shénme yǒuqù de xīnwén ma	Are there any interesting news items in the paper this morning?	2.889
他的死使我们大家都大为震惊。	tā de sǐ shǐ wǒmen dàjiā dōu dàwéi zhènjīng	His death was a great shock to us all.	2.889
他把醋洒在鱼和土豆片上。	tā bǎ cù sǎ zài yú hé tǔdòu piàn shàng	He sprinkled vinegar on his fish and chips.	2.889
为了确定他在家，我事先打电话给他。	wèile quèdìng tā zài jiā wǒ shìxiān dǎdiànhuà gěi tā	To make sure that he was at home, I called him up in advance.	2.889
她抱怨名单上遗漏了她的名字。	tā bàoyuàn míngdān shàng yílòu le tā de míngzi	She complained about the omission of her name from the list.	2.889
我并非因为他有学问而尊敬他。	wǒ bìngfēi yīnwèi tā yǒuxuéwèn ér zūnjìng tā	I do not respect him because he is knowledgeable.	2.889
别把秘密告诉他，他的嘴不严。	bié bǎ mìmì gàosu tā tā de zuǐ bù yán	Never tell him a secret; he’s got a loose tongue.	2.889
你知道她为什么对他如此冷淡吗？	nǐ zhīdào tā wèishénme duì tā rúcǐ lěngdàn ma	Do you know why she is so strange to him?	2.889
他说他如何如何赚钱，我就不太相信，我们认识以来他总是喜欢吹牛。	tā shuō tā rúhé rúhé zhuànqián wǒ jiù bù tài xiāngxìn wǒmen rènshi yǐlái tā zǒngshì xǐhuan chuīniú	I don’t believe all he says about the profits he is making; ever since I have known him he has liked to talk big.	2.889
请假离开办公室之后我赶紧去了医院。	qǐngjià líkāi bàngōngshì zhīhòu wǒ gǎnjǐn qù le yīyuàn	After asking off my office, I went to the hospital immediately.	2.889
我们都称赞了她烹饪技术的高超。	wǒmen dōu chēngzàn le tā pēngrèn jìshù de gāochāo	We all praised the excellence of her cooking.	2.889
噪音令人讨厌，尤其当你想睡觉的时候。	zàoyīn lìngrén tǎoyàn yóuqí dāng nǐ xiǎng shuìjiào de shíhou	Noise is unpleasant, especially when you are trying to sleep.	2.889
他得到越多，想要的也越多。	tā dédào yuè duō xiǎngyào de yě yuè duō	The more he has, the more he wants.	2.889
步行了四个小时以后，我们开始累了。	bùxíng le sì gè xiǎoshí yǐhòu wǒmen kāishǐ lèi le	After walking for four hours we were beginning to flag.	2.889
我们很遗憾无法再考虑你的情况。	wǒmen hěn yíhàn wúfǎ zài kǎolǜ nǐ de qíngkuàng	We regret that we are unable to reconsider your case.	2.889
我不打算放弃我的假日来迁就你， 你不听也得听！	wǒ bù dǎsuàn fàngqì wǒ de jiàrì lái qiānjiù nǐ nǐ bù tīng yě dé tīng	I’m not giving up my holiday to suit you, so you can put that in your pipe and smoke it！	2.895
请你拼一下你的姓好吗？	qǐng nǐ pīn yīxià nǐ de xìng hǎo ma	Would you please spell your last name?	2.9
楼上的房间要比底层的暖和得多。	lóushàng de fángjiān yào bǐ dǐcéng de nuǎnhuo dé duō	The upstairs rooms are much warmer than those on the ground floor.	2.9
我去睡觉，茶沏好后告诉我一声。	wǒ qù shuìjiào chá qī hǎo hòu gàosu wǒ yīshēng	I’m going to sleep, tip me the wink when tea’s ready.	2.9
她终于嫁给了最执着追求她的人。	tā zhōngyú jià gěi le zuì zhízhuó zhuīqiú tā de rén	She eventually married the most persistent one of her admirers.	2.9
她的小说描写的是伦敦现代的生活。	tā de xiǎoshuō miáoxiě de shì Lúndūn xiàndài de shēnghuó	Her novel depicts life in modern London.	2.9
他真有胆量，穿着那身衣服去工作。	tā zhēn yǒudǎnliàng chuānzhuó nà shēn yīfu qù gōngzuò	He’s got a nerve, going to work dressed like that.	2.9
我知道你不喜欢他，但你至少要照顾一下面子去参加他公司的开典仪式。	wǒ zhīdào nǐ bù xǐhuan tā dàn nǐ zhìshǎo yào zhàogu yīxià miànzi qù cānjiā tā gōngsī de kāi diǎn yíshì	I know you didn’t like him, but at least have the decency to go to his opening ceremony of the company.	2.9
还好。顺便问一下，你母亲怎么样？她好吗？	háihǎo shùnbiàn wèn yīxià nǐ mǔqīn zěnmeyàng tā hǎo ma	Not bad. By the way, how is your mother? Is she all right?	2.9
就我而言，我并不反对你的计划。	jiù wǒ éryán wǒ bìngbù fǎnduì nǐ de jìhuà	As far as I am concerned, I’m not against your plan.	2.9
唉，我看什么都不如偶尔受点挫折更能使你明白你是多么的幸运了。	āi wǒ kàn shénme dōu bùrú ǒu’ěr shòu diǎn cuòzhé gèng néng shǐ nǐ míngbai nǐ shì duōme de xìngyùn le	Ah well, I suppose there’s nothing like an occasional setback to make you realize how lucky you really are.	2.9
这两间大教室已经分配给我们了。	zhè liǎng jiān dà jiàoshì yǐjīng fēnpèi gěi wǒmen le	The two large classrooms have been assigned to us.	2.9
青春期对人的性格形成是非常重要的。	qīngchūnqī duì rén de xìnggé xíngchéng shì fēicháng zhòngyào de	The period of adolescence is very important in forming one’s character.	2.9
我的护照再过两个月就到期了。	wǒ de hùzhào zài guò liǎng gè yuè jiù dàoqī le	My passport is due to expire in two months.	2.9
在有关钱的问题上，我总是尽量小心谨慎。	zài yǒuguān qián de wèntí shàng wǒ zǒngshì jǐnliàng xiǎoxīnjǐnshèn	Where money is concerned, I always try to be very careful.	2.9
你被蚊子咬的地方还在痒吗？	nǐ bèi wénzi yǎo de dìfang hái zài yǎng ma	Are your mosquito bites still itching?	2.9
他和妻子吵架後就把她抛弃了。	tā hé qīzi chǎojià hòu jiù bǎ tā pāoqì le	He had a row with his wife and just walked out on her.	2.9
在一些问题上，他仍然保留自己的意见。	zài yīxiē wèntí shàng tā réngrán bǎoliú zìjǐ de yìjiàn	He still reserved his opinion on some points.	2.9
他总是把时间花在毫无意义的事上。	tā zǒngshì bǎ shíjiān huā zài háowú yìyì de shì shàng	He always spend his time to no purpose.	2.9
她的钱被一个奸诈的会计骗去了。	tā de qián bèi yī gè jiānzhà de kuàijì piàn qù le	She was defrauded of her money by a dishonest accountant.	2.909
困扰我的不是他的工作，而是他的态度。	kùnrǎo wǒ de bùshì tā de gōngzuò érshì tā de tàidu	It’s not his work that bothers me; it’s his attitude.	2.909
他连忙接受了我提供的东西或办法等。	tā liánmáng jiēshòu le wǒ tígōng de dōngxi huò bànfǎ děng	He snapped at the offer I made him.	2.909
不应该让退休的人感到自己是个闲人	bù yīnggāi ràng tuìxiū de rén gǎndào zìjǐ shì gè xiánrén	A retired person should not be made to feel he’s on the shelf.	2.909
你应很好利用宝贵的每一分钟去学习。	nǐ yīng hěn hǎo lìyòng bǎoguì de měiyī fēnzhōng qù xuéxí	You should make good use of every precious minute to study.	2.909
因为尺子被书盖住了，所以我没找到它。	yīnwèi chǐzi bèi shū gài zhù le suǒyǐ wǒ méi zhǎodào tā	I could not find my ruler because it was covered up by the books.	2.909
这三个人根据各自的能力被分配了工作。	zhè sān gèrén gēnjù gèzì de nénglì bèi fēnpèi le gōngzuò	The three men were given work according to their respective abilities.	2.909
她是个很好的妇人，冷酷不是她的本性。	tā shì gè hěn hǎo de fùrén lěngkù bùshì tā de běnxìng	She’s a very good woman; unkindness is foreign to her nature.	2.917
我送给玛丽一个苹果换我最喜欢吃的香蕉。	wǒ sònggěi Mǎlì yī gè píngguǒ huàn wǒ zuì xǐhuan chī de xiāngjiāo	I gave Mary an apple in exchange for my favorite banana.	2.917
我们用他给我们带来的面粉做了一些面包。	wǒmen yòng tā gěi wǒmen dàilái de miànfěn zuò le yīxiē miànbāo	We made some bread with the flour he bought for us.	2.917
我可以在我的寓所里为你提供一个床位。	wǒ kěyǐ zài wǒ de yùsuǒ lǐ wéi nǐ tígōng yī gè chuángwèi	I’ll fit you up with a bed at my flat.	2.917
婴儿把吃进去的东西吐在桌子上了。	yīng’ér bǎ chī jìnqù de dōngxi tǔ zài zhuōzi shàng le	The baby spat its food (out) onto the table.	2.917
我不知道这件衣服的价钱，它的标签掉了。	wǒ bù zhīdào zhè jiàn yīfu de jiàqian tā de biāoqiān diào le	I don’t know the price of the dress; its ticket has fallen off.	2.917
如果阁下愿意给我时间，我就能拿出证据来。	rúguǒ géxià yuànyì gěi wǒ shíjiān wǒ jiù néng náchū zhèngjù lái	If your Lordship will give me time, I will produce the evidence.	2.917
他擦去试卷上的铅笔笔迹然后递给了老师。	tā cā qù shìjuàn shàng de qiānbǐ bǐjì ránhòu dì gěi le lǎoshī	He erased pencil marks form the test paper and handed to the teacher.	2.917
有命令要我们必须在一小时内挖好战壕。	yǒu mìnglìng yào wǒmen bìxū zài yī xiǎoshí nèi wā hǎo zhànháo	Orders came that we should spade the trench in an hour.	2.917
我的部分工作是同我们的供应商保持良好的关系。	wǒ de bùfen gōngzuò shì tóng wǒmen de gōngyìngshāng bǎochí liánghǎo de guānxi	Part of my job is to maintain good relationship with our suppliers.	2.917
你撞到了我的手肘，弄坏了我正在画的图画。	nǐ zhuàng dàoliǎo wǒ de shǒuzhǒu nònghuài le wǒ zhèngzài huà de túhuà	You jogged my elbow and spoiled what I was drawing.	2.923
在年终联欢会季节，晚上是几乎不可能叫到计程车的。	zài niánzhōng liánhuānhuì jìjié wǎnshang shì jīhū bùkěnéng jiào dào jìchéngchē de	It’s next to impossible to catch a taxi at night during the year- end party season.	2.923
当她看到他走过来的时候，她的脸亮了起来。	dāng tā kàn dào tā zǒuguò lái de shíhou tā de liǎn liàng le qilai	Her face lit up when she saw he was coming.	2.923
这个证据证实了我认为他是间谍的这一看法。	zhège zhèngjù zhèngshí le wǒ rènwéi tā shì jiàndié de zhè yī kànfǎ	This evidence reinforces my view that he is a spy.	2.923
我必须找一个人，在我离开期间代理我的职务。	wǒ bìxū zhǎo yīgèrén zài wǒ líkāi qījiān dàilǐ wǒ de zhíwù	I must find someone to act as a deputy for me during my absence.	2.923
他急切地取食物，因为从黎明开始，他一直没吃东西。	tā jíqiè dì qǔ shíwù yīnwèi cóng límíng kāishǐ tā yīzhí méi chī dōngxi	He took the food eagerly, for he had eaten nothing since dawn.	2.923
他总是用这样得方式说话，所以每个人都讨厌他。	tā zǒngshì yòng zhèyàng dé fāngshì shuōhuà suǒyǐ měigerén dōu tǎoyàn tā	He always talks in such a way that everyone dislikes him.	2.923
当知道他有许多敌人时，他开始担心他的性命。	dāng zhīdào tā yǒu xǔduō dírén shí tā kāishǐ dānxīn tā de xìngmìng	Knowing he had many enemies, he went about in fear of his life.	2.923
我很匆忙， 所以随便地把衣服穿上了。	wǒ hěn cōngmáng suǒyǐ suíbiàn dì bǎ yīfu chuānshang le	I was in such a hurry that I put my clothes on anyhow.	2.923
真不幸，上午我的自行车丢了，下午钱包又被偷了！	zhēn bùxìng shàngwǔ wǒ de zìxíngchē diū le xiàwǔ qiánbāo yòu bèi tōu le	It’s luckless, I lost my bicycle in the morning and my wallet was stolen in the afternoon！	2.929
她经验更丰富，这是她得到那份工作的决定性因素。	tā jīngyàn gèng fēngfù zhè shì tā dédào nà fèn gōngzuò de juédìngxìng yīnsù	Her greater experience tipped the balance in her favour and she got the job.	2.929
他的许多困难都是因为他的知识的贫乏而产生的。	tā de xǔduō kùnnan dōu shì yīnwèi tā de zhīshi de pínfá ér chǎnshēng de	His difficulties issue from his lack of knowledge.	2.929
记住，你现在当家作主了，要大胆说话，有什么想法就告诉我们。	jìzhu nǐ xiànzài dāngjiāzuòzhǔ le yào dàdǎn shuōhuà yǒu shénme xiǎngfǎ jiù gàosu wǒmen	Remember you are one of the masters now, so speak up and tell us what you think.	2.929
我们来抛硬币决定谁先走吧，你是要正面还是要反面？	wǒmen lái pāo yìngbì juédìng shéi xiān zǒu ba nǐ shì yào zhèngmiàn háishi yào fǎnmiàn	Let’s flip a coin to decide who should go first - do you want heads or tails?	2.938
她是个好演员，但仍需要时间去熟悉她要扮演的角色。	tā shì gè hǎo yǎnyuán dàn réng xūyào shíjiān qù shúxī tā yào bànyǎn de juésè	She is a good actress, but still needs time to grow into the part she is playing.	2.938
我们还以为那是最坏的情况呢，可没想到更糟的还在后面。	wǒmen hái yǐwéi nàshi zuì huài de qíngkuàng ne kě méixiǎngdào gèng zāo de hái zài hòumian	We thought that the situation was as bad as it could be, but worse was to follow.	2.938
他在明知他的性命有可能受到威胁的情况下接任了那职位。	tā zài míngzhī tā de xìngmìng yǒukěnéng shòudào wēixié de qíngkuàng xià jiē rèn le nà zhíwèi	He took over the post in the knowledge that it might endanger his life.	2.941
即使这工作要花掉我六个星期的时间，我仍决心要把它完成。	jíshǐ zhè gōngzuò yào huādiào wǒ liù gè xīngqī de shíjiān wǒ réng juéxīn yào bǎ tā wánchéng	Even if it will take me six weeks, I am determined to finish the job.	2.941
他在他们的眼光里是坍台了；他在贫民前面丢了体面和地位。	tā zài tāmen de yǎnguāng lǐ shì tān tái le tā zài pínmín qiánmiàn diū le tǐmiàn hé dìwèi	He was degraded in their eyes; he had lost caste and station before the very paupers.	2.944
如果我是你，我现在就不会进去找他。他这会儿心情不好，见谁骂谁，看什么都不顺眼。	rúguǒ wǒ shì nǐ wǒ xiànzài jiù bùhuì jìnqù zhǎo tā tā zhèhuìr xīnqíng bùhǎo jiàn shéi mà shéi kàn shénme dōu bù shùnyǎn	I shouldn’t go in and see him now if I were you. He’s having one of his bad days, swearing at everything and everyone.	2.958
