不要大家一齐说！	bùyào dàjiā yīqí shuō	Don’t all speak at once！	6
这里说的话必须保密。	zhèlǐ shuō dehuà bìxū bǎomì	Whatever is said here must be kept secret.	6
足球队输球后球迷们在街上聚众闹事。	zúqiúduì shū qiú hòu qiúmí men zài jiēshang jùzhòng nàoshì	The football supporters ran riot through the town after the defeat of their team.	6
她穿着一件黑色丝质晚礼服。	tā chuānzhuó yī jiàn hēisè sī zhì wǎnlǐfú	She wore a black silk evening gown.	6
我很後悔不该说那话。	wǒ hěn hòuhuǐ bùgāi shuō nà huà	I regret what I said.	6
哨兵们都已各就各位。	shàobīng men dōu yǐ gè jiù gèwèi	The sentries are all at their posts.	6
村民们撑起摇摇欲坠的茅棚。	cūnmín men chēng qǐ yáoyáoyùzhuì de máopéng	The villagers shored up sagging huts.	6
标枪在空中沿曲线运动。	biāoqiāng zài kōngzhōng yán qūxiàn yùndòng	The spear curved through the air.	6
有些新车在投放市场前没有进行行驶性检验。	yǒuxiē xīn chē zài tóufàngshìchǎng qián méiyǒu jìnxíng xíngshǐ xìng jiǎnyàn	Some new cars are not given road tests before they are put on the market.	6
出版商们总吹捧他们的新书	chūbǎnshāng men zǒng chuīpěng tāmen de xīn shū	Publishers who puff their new books.	6
侵略军在那里横行霸道，杀人放火，抢劫财物。	qīnlüèjūn zài nàli héngxíngbàdào shārénfànghuǒ qiǎngjié cáiwù	The invading troops rampaged about in the area, killing, burning and looting.	6
工人们正在道路下面铺设管道。	gōng rénmen zhèngzài dàolù xiàmian pūshè guǎndào	The workers are laying pipes under the road.	6
这个城市没有盗贼。	zhège chéngshì méiyǒu dàozéi	This city is free from thieves.	6
伤口用绷带包扎着。	shāngkǒu yòng bēngdài bāozā zhe	The wound was bound up by bandage.	6
有些小炊具非但没有用处反而碍事。	yǒuxiē xiǎo chuījù fēidàn méiyǒu yòngchu fǎn’ér àishì	Some kitchen gadgets are more of a hindrance than a help.	6
火车缓缓地进站。	huǒchē huǎnhuǎn dì jìn zhàn	The train slowly came to the station.	6
碰巧在附近有个公用电话亭。	pèngqiǎo zài fùjìn yǒu gè gōngyòngdiànhuà tíng	It happened that there was a telephone booth nearby.	6
【谚】一根筷子易折断，十根筷子硬如铁。	yàn yī gēn kuàizi yì zhéduàn shí gēn kuàizi yìng rú tiě	Weak things united become strong.	6
那条街经常交通阻塞。	nà tiáo jiē jīngcháng jiāotōngzǔsè	There is always traffic congestion in that street.	6
用混凝土砌砖。	yòng hùnníngtǔ qìzhuān	The bricks are bedded in concrete.	6
我登台演出前总要温习一下台词。	wǒ dēng tái yǎnchū qián zǒngyào wēnxí yīxià táicí	I always run over my lines before going on stage.	6
这种新药还没有投放市场。	zhèzhǒng xīn yào hái méiyǒu tóufàngshìchǎng	This new drug is not yet commercially available.	6
雨水从树上滴下。	Yǔshuǐ cóng shù shàng dīxià	Rain was dripping (down) from the trees.	6
冷天出门时要披上披肩。	lěngtiān chūmén shí yào pī shàng pījiān	You should put a robe on if you go out in a cold day.	6
酒存放得越久越醇。	jiǔ cúnfàng dé yuè jiǔ yuè chún	Wine improves with age.	6
这种豌豆长着长豆荚。	zhèzhǒng wāndòu cháng zhe cháng dòujiá	This kind of pea has a long pod.	6
这种新型空调没有噪音。	zhèzhǒng xīnxíng kōngtiáo méiyǒu zàoyīn	This new style of air conditioner is noiseless.	6
这个病人应该隔离。	zhège bìngrén yīnggāi gélí	This patient should be separated from the others.	6
这些药丸可以止痛。	zhèxiē yàowán kěyǐ zhǐtòng	These pills bring relief from pain.	6
他们集资到一大笔款子。	tāmen jízī dào yī dà bǐ kuǎnzi	They clubbed together a large sum.	6
炭笔画用这种炭笔画成的速描或画	tàn bǐhuà yòng zhèzhǒng tàn bǐhuà chéng de sù miáo huò huà	A sketch or drawing made with this charcoal.	6
愿主赐福于你们大家。	yuàn zhǔ cìfú yú nǐmen dàjiā	The blessing of the Lord be upon you all.	6
花岗伟晶岩一种有时富含铀、钨和钽等稀有元素的粗纹理花岗岩	huā gǎng wěijīngyán yīzhǒng yǒushí fù hán yóu wū hé tǎn děng xīyǒuyuánsù de cū wénlǐ huāgāngyán	A coarse-grained granite, sometimes rich in rare elements such as uranium, tungsten, and tantalum.	6
商人向他们供应货物。	shāngrén xiàng tāmen gōngyìng huòwù	The merchant supplies goods to them.	6
壁炉凸出在外，伸入房间。	bìlú tūchū zàiwài shēn rù fángjiān	The fireplace came out into the room.	6
【谚】先还债，后慷慨。	yàn xiān huánzhài hòu kāngkǎi	Be just before you are generous.	6
战士们发誓战斗到底。	zhànshì men fāshì zhàndòu dàodǐ	The soldiers swore to fight it out.	6
抽彩仪式星期六举行。	chōu cǎi yíshì Xīngqīliù jǔxíng	The draw for the raffle takes place on Saturday.	6
货款可以分期支付。	huòkuǎn kěyǐ fēnqī zhīfù	The price of the goods is payable in instalments.	6
在暴动中，农奴们以赤手空拳对付钢枪铁炮。	zài bàodòng zhōng nóngnú men yǐ chìshǒukōngquán duìfu gāng qiāng tiě pào	In the uprising the serfs fought with bare hands against gunfire.	6
讣闻死亡后发表的通告，有时附有死者简要传记	fùwén sǐwáng hòu fābiǎo de tōnggào yǒushí fù yǒu sǐzhě jiǎnyào zhuànjì	A published notice of a death, sometimes with a brief biography of the deceased.	6
这个商人收到了一船茶叶。	zhège shāngrén shōu dàoliǎo yī chuán cháyè	The merchant had received a shipment of tea.	6
这是一个黑暗无月的夜晚。	zhè shì yī gè hēi’àn wú yuè de yèwǎn	It’s a dark and moonless night.	6
那两个情人只是偷偷地会面。	nà liǎng gè qíngrén zhǐshì tōutōu dì huìmiàn	The two lovers had met only by stealth.	6
这封信只用一张纸写成。	zhè fēng xìn zhǐ yòng yī zhāng zhǐ xiě chéng	The letter was written on a single sheet of paper.	6
这个工人用一个铁箍修桶。	zhège gōngrén yòng yī gè tiěgū xiū tǒng	The worker repaired the barrel with a hoop iron.	6
这个瘤不是恶性的。	zhège liú bùshì èxìng de	The growth is not malignant.	6
这个词是一种野兽的名称。	zhège cí shì yīzhǒng yěshòu de míngchēng	This word denotes a certain kind of animal.	6
这个和尚穿着灰色的僧袍。	zhège héshang chuānzhuó huīsè de sēng páo	This monk wears a gray frock.	6
我不会解这个方程式。	wǒ bùhuì jiě zhège fāngchéngshì	I can’t make this equation come out.	6
神父听取那个青年的忏悔。	shénfu tīngqǔ nàge qīngnián de chànhuǐ	The priest confessed the young man.	6
大卫的家离环球剧院很近。	Dàwèi de jiā lí huánqiú jùyuàn hěn jìn	David’s house is quite close to the Global Theater.	6
一个流浪汉来到门前讨饭吃。	yī gè liúlànghàn láidào ménqián tǎofàn chī	A tramp come to the door and ask for food.	6
从高处往下看， 那些农田像是几何图案。	cóng gāochù wǎng xià kàn nàxiē nóngtián xiàng shì jǐhé tú’àn	Seen from above, the fields looked like a geometrical pattern.	6
用那样的花招欺负一个老太太， 可真卑鄙。	yòng nàyàng de huāzhāo qīfu yī gè lǎotàitai kě zhēn bēibǐ	That was a scurvy trick to play on an old lady.	6
现代战争并不是好玩的事。	xiàndài zhànzhēng bìng bùshì hǎowán de shì	There is not much comedy in modern war.	6
车轮在泥路上留下凹痕。	chēlún zài ní lùshang liúxià āohén	Wheels leave grooves in dirt roads.	6
从一副牌中任意选出一张	cóng yī fù pái zhōng rènyì xuǎnchū yī zhāng	Chose a card at random from the deck.	6
这盘菜配有什锦泡菜。	zhè pán cài pèi yǒu shíjǐn pàocài	The dish was accompanied by a variety of pickles.	6
那老人好容易喘著气说出几句话。	nà lǎorén hǎoróngyì chuǎn zhe qì shuōchū jǐ jù huà	The old man manage to puff out a few words.	6
她多才多艺， 能歌善舞。	tā duōcáiduōyì nénggēshànwǔ	Dancing and singing were among her many accomplishments.	6
英军的阵线被迫后退一段距离。	Yīngjūn de zhènxiàn bèipò hòutuì yī duàn jùlí	The British line was forced back a short distance.	6
一位老式汽车收藏家要弗兰克留神1906年产的煤气前灯。	yī wèi lǎoshì qìchē shōucángjiā yào Fúlánkè liúshén niánchǎn de méiqì qiándēng	A collector of antique cars asked Frank to look out for a1906 gas head lamp.	6
他们中大多数侨民是爱国主义者。	tāmen zhōng dàduōshù qiáomín shì àiguózhǔyì zhě	Most emigrants among them are patriots.	6
那楝房屋下陷约十公分。	nà liàn fángwū xiàxiàn yuē shí gōngfēn	The house has sunk about ten centimeters.	6
一个竭力鼓吹自由主义的政治家	yī gè jiélì gǔchuī zìyóuzhǔyì de zhèngzhìjiā	A politician who beats the drum for liberalism.	6
螺纹接口用于接合电气装置和引出盒的螺纹接口	luówén jiēkǒu yòngyú jiēhé diànqì zhuāngzhì hé yǐnchū hé de luówén jiēkǒu	A threaded electrical fitting to connect a fixture to an outlet box.	6
现在房屋大多用电照明。	xiànzài fángwū dàduō yòng diànzhàomíng	Nowadays, houses are mostly lit by electricity.	6
玩具店就是幼儿的乐园。	wánjù diàn jiùshì yòu’ér de lèyuán	The toy-shop is a fairyland for young children.	6
大街两旁的梧桐树已冒芽长叶。	dàjiē liǎngpáng de wútóng shù yǐ mào yá cháng yè	The plane trees lining the main street are leafing out.	6
这家商店供应各种野营用品。	zhè jiā shāngdiàn gōngyìng gèzhǒng yěyíng yòngpǐn	The shop furnishes everything that is needed for camping.	6
“洁白如雪”是明喻。	jiébái rú xuě shì míngyù	“As white as snow” is a simile.	6
到这时，罗马帝国已日益衰败。	dào zhèshí Luómǎ Dìguó yǐ rìyì shuāibài	By now the power of the Roman Empire was on the wane.	6
海水拍打著悬崖的底部。	hǎishuǐ pāidǎ zhe xuányá de dǐbù	The sea washes the base of the cliffs.	6
他们应该设法阻止价钱上涨。	tāmen yīnggāi shèfǎ zǔzhǐ jiàqian shàngzhǎng	They should try to keep prices from rising.	6
劫匪假装成保安人员进入银行。	jiéfěi jiǎzhuāng chéng bǎo’ānrényuán jìnrù yínháng	The robbers got into the bank by masquerading as security men.	6
滚石不生苔；转业不聚财。	gǔn shí bù shēngtái zhuǎnyè bù jù cái	A rolling stone gathers no moss.	6
占星家声称能预知祸福。	zhānxīngjiā shēngchēng néng yùzhī huòfú	Astrologers claim to be able to divine what the stars hold in store for us.	6
水色宝石的透明度及光洁度	shuǐ sè bǎoshí de tòumíngdù jí guāngjié dù	The transparency and luster of a gem.	6
仆人唱名通报史密斯先生来访。	púrén chàngmíng tōngbào Shǐmìsī xiānsheng láifǎng	The servant announced Mr. Smith.	6
该舰队正在波罗的海演习。	gāi jiànduì zhèngzài Bōluódì Hǎi yǎnxí	The fleet is manoeuvring in the Baltic.	6
空中爆炸炸弹或炮弹的空中爆炸	kōngzhōng bàozhà zhàdàn huò pàodàn de kōngzhōng bàozhà	Explosion of a bomb or shell in the atmosphere.	6
牧师在圣坛前行鞠躬礼。	mùshī zài shèng tán qián xíng jūgōng lǐ	The priest bowed down before the altar.	6
牙科医生常常给患者补牙。	yákēyīshēng chángcháng gěi huànzhě bǔyá	A dentist often has to fill teeth.	6
军队按时沿边界巡逻。	jūnduì ànshí yán biānjiè xúnluó	The army regularly patrol (along) the border.	6
他这个人做事一不做二不休--向慈善事业捐款不捐则已， 一捐就是一大笔。	tā zhège rén zuòshì yī bù zuò èr bùxiū xiàng císhàn shìyè juānkuǎn bù juān zé yǐ yī juān jiùshì yī dà bǐ	He’s not a man who does things by halves -- either he donates a huge sum to a charity or he gives nothing.	6
那种鸟雄鸟的喙呈橙色， 与雌鸟不同。	nàzhǒng niǎo xióng niǎo de huì chéng chéngsè yǔ cí niǎo bùtóng	The male’s orange beak differentiates it from the female.	6
请各位将酒杯斟满， 向新娘、 新郎祝酒！	qǐng gèwèi jiāng jiǔbēi zhēn mǎn xiàng xīnniáng xīnláng zhùjiǔ	Please charge your glasses and drink a toast to the bride and groom！	6
变频器将无线电讯号从一种频率转换成另一种频率的电子装置	biànpín qì jiāng wúxiàndiàn xùnhào cóng yīzhǒng pínlǜ zhuǎnhuàn chéng lìngyī zhǒng pínlǜ de diànzǐ zhuāngzhì	An electronic device that converts one frequency of a radio signal to another.	6
州议院议员马里兰州、弗吉尼亚州和西弗吉尼亚州三州国会议员中的众议院议员	zhōu yìyuàn yìyuán Mǎlǐlánzhōu Fújíníyàzhōu hé Xī Fújíníyàzhōu sān zhōu guóhuìyìyuán zhòngdì Zhòngyìyuàn yìyuán	A member of a House of Delegates, the lower house of the Maryland, Virginia, or West Virginia legislature.	6
薄皮，薄膜如生物膜或液体膜等细薄的皮或膜	báo pí bómó rú shēngwù mó huò yètǐ mó děng xì báo de pí huò mó	A thin skin or film, such as an organic membrane or a liquid film.	6
陶瓷学制作陶瓷物品的工艺或技术，尤指用耐火粘土制	táocí xué zhìzuò táocí wùpǐn de gōngyì huò jìshù yóuzhǐ yòng nàihuǒ niántǔ zhì	The art or technique of making objects of ceramic, especially from fired clay.	6
大浪在堤上冲出一个缺口。	dàlàng zài dī shàng chōngchū yī gè quēkǒu	The huge waves made a breach in the sea wall.	6
长颈鹿从高高的树上吃掉嫩树叶子。	chángjǐnglù cóng gāo gāo de shù shàng chīdiào nèn shù yèzi	The giraffe eats tender leaf from the tree highly.	6
大猫叼著小猫的颈背。	dà māo diāo zhe xiǎomāo de jǐng bèi	The cat picked up the kitten by the scruff of its neck.	6
药物有时具有令人不快的副作用。	yàowù yǒushí jùyǒu lìngrénbùkuài de fùzuòyòng	Medicines sometimes have unpleasant side effects.	6
那个贼偷偷（从後门）溜出去了。	nàge zéi tōutōu cóng hòu mén liū chūqù le	The thief slipped out (by the back door).	6
这一公约并没有促进国际和平。	zhè yī gōngyuē bìng méiyǒu cùjìn guójì hépíng	That pact didn’t advance peace among nations.	6
这家戏院只能容纳250人。	zhè jiā xìyuàn zhǐnéng róngnà rén	The theatre admits only 250 people.	6
把德语课本翻到第28页。	bǎ Déyǔ kèběn fān dào dì yè	Open your German readers at page 28.	6
出租人可驱逐不付租金的承租人。	chūzū rén kě qūzhú bù fù zūjīn de chéngzūrén	The lessor can evict the lessee for failure to pay rent.	6
这使我想起那句俗话，“三思而后行”。	zhè shǐ wǒ xiǎngqǐ nà jù súhuà sānsī’érhòuxíng	Remind me of the old saying, “look before you leap”.	6
部队已在几个地点登陆。	bùduì yǐ zài jǐge dìdiǎn dēnglù	Troops have been landed at several points.	6
下议院凌晨三时仍在开会。	xiàyìyuàn língchén sān shí réng zài kāihuì	The House of Commons was still sitting at 3 am.	6
他本是国王的幸臣， 一朝失宠众人无不感到意外。	tā běn shì guówáng de xìng chén yī cháo shīchǒng zhòngrén wúbù gǎndào yìwài	He had been the king’s favourite, and his sudden fall from grace surprised everyone.	6
这种液体天冷时凝结得快些。	zhèzhǒng yètǐ tiānlěng shí níngjié dé kuài xiē	This liquid gels faster in cold weather.	6
他们有三个队员防守球门。	tāmen yǒu sān gè duìyuán fángshǒu qiúmén	They had three players defending the goal (against attack).	6
陪审团做出被告无罪的裁决。	péishěntuán zuòchū bèigào wúzuì de cáijué	The jury returned a verdict of (ie reached a decision that the accused was) not guilty.	6
趋向总体的倾向、动向或进程	qūxiàng zǒngtǐ de qīngxiàng dòngxiàng huò jìnchéng	A general tendency, movement, or course.	6
他立正敬礼，鞋后跟发出咔嗒一声。	tā lìzhèng jìnglǐ xié hòu gēn fāchū kādā yīshēng	He saluted with a click of his heels.	6
珠母般的具有珍珠般的光泽的	zhūmǔ bān de jùyǒu zhēnzhū bān de guāngzé de	Having a luster resembling that of pearls.	6
难民处境惨苦真叫我牵肠割肚。	nànmín chǔjìng cǎn kǔ zhēn jiào wǒ qiān cháng gē dǔ	The plight of the refugees really wrung my heart.	6
火车一开， 一阵凉风吹来， 我们顿感凉爽。	huǒchē yī kāi yīzhèn liáng fēng chuī lái wǒmen dùn gǎn liángshuǎng	As the train began to move a pleasant draught cooled us all down.	6
主管人，尤指大学校长或学院院长	zhǔguǎn rén yóuzhǐ dàxué xiàozhǎng huò xuéyuàn yuànzhǎng	A president, especially of a college or university.	6
克鲁格金币南非共和国发行的一盎司金币	kè lǔ gé jīnbì Nánfēi gònghéguó fāxíng de yī àngsī jīnbì	A one-ounce gold coin of the Republic of South Africa.	6
现在分娩时常用硬膜外注射。	xiànzài fēnmiǎn shí chángyòng yìng mó wài zhùshè	Epidurals are now often used during childbirth.	6
孩子们早已吃掉不少食物。	háizimen zǎoyǐ chīdiào bùshǎo shíwù	Already the children had made considerable inroads on the food.	6
警方向群众呼吁不要惊慌。	jǐng fāngxiàng qúnzhòng hūyù bùyào jīnghuāng	The police appealed to the crowd not to panic.	6
医生无法解释高烧何以持久不退。	yīshēng wúfǎ jiěshì gāoshāo héyǐ chíjiǔ bù tuì	The doctor couldn’t explain the persistence of the high temperature.	6
这些鲜红色窗帘显得棕色地毯黯然失色。	zhèxiē xiān hóngsè chuānglián xiǎnde zōngsè dìtǎn ànránshīsè	The bright red of the curtain kill the brown of the carpet.	6
这样严竣的法令不易实施。	zhèyàng yánjùn de fǎlìng bùyì shíshī	Such a strict law is not easily enforceable.	6
今年的葡萄酒产量前景不佳。	jīnnián de pútaojiǔ chǎnliàng qiánjǐng bùjiā	The prospects for this year’s wine harvest are poor.	6
时钟鸣响声打破了寂静。	shízhōng míng xiǎngshēng dǎpò le jìjìng	The silence was succeeded by the striking of a clock.	6
警察用探照灯照射这所房子。	jǐngchá yòng tànzhàodēng zhàoshè zhè suǒ fángzi	The police shone a searchlight on the house.	6
商店连同其商誉一并出售。	shāngdiàn liántóng qí shāngyù yībìng chūshòu	The goodwill is being sold together with the shop.	6
齿隙两齿之间的间隙或空隙	chǐ xì liǎng chǐ zhījiān de jiànxì huò kòngxì	A gap or space between two teeth.	6
装甲部队部署装甲车辆的战斗部队，如坦克	zhuāngjiǎ bùduì bùshǔ zhuāngjiǎchēliàng de zhàndòu bùduì rú tǎnkè	The combat arm that deploys armored vehicles, such as tanks.	6
道路[通道]畅通吗？	dàolù tōngdào chàngtōng ma	Is the way/passage free?	6
他们举起拳头向领袖致敬。	tāmen jǔqǐ quántou xiàng lǐngxiù zhìjìng	They raised their fists in salute to their leader.	6
心律失常不规则的心跳强度或节奏	xīn lǜ shīcháng bùguīzé de xīntiào qiángdù huò jiézòu	An irregularity in the force or rhythm of the heartbeat.	6
我靠父母扶养勉强过活。	wǒkào fùmǔ fúyǎng miǎnqiǎng guòhuó	I can just scrape along on what my parents give me.	6
堤坝建成後水已加深。	dībà jiànchéng hòu shuǐ yǐ jiāshēn	The water deepened after the dam was built.	6
电力供应已在电源处截断。	diànlì gōngyìng yǐ zài diànyuán chǔ jiéduàn	The electricity supply has been cut off/disconnected at the mains.	6
飞机猛然俯冲致使驾驶员昏厥。	fēijī měngrán fǔchōng zhìshǐ jiàshǐyuán hūnjué	The plane dived suddenly, causing the pilot to black out.	6
他们须通过齐膝的烂泥和堆积物， 磕磕绊绊来到遇难者身旁。	tāmen xū tōngguò qíxī de lànní hé duījī wù kēkebànbàn láidào yùnànzhě shēn páng	They had to wade knee-deep through mud and debris to reach the victims.	6
截导管这种管子的一部分或一段	jié dǎoguǎn zhèzhǒng guǎnzi de yībùfèn huò yī duàn	A section or piece of such a tube.	6
首席书记官某些法院中的最高书记官	shǒuxí shūji guān mǒuxiē fǎyuàn zhòngdì zuì gāo shūji guān	The principal clerk in certain courts of law.	6
八条大道从广场呈辐射形伸展出去。	bā tiáo dàdào cóng guǎngchǎng chéng fúshè xíng shēnzhǎn chūqù	Eight roads radiate from the square.	6
现实生活并不象人们想象的那样美好。	xiànshí shēnghuó bìngbù xiàng rénmen xiǎngxiàng de nàyàng měihǎo	Real life isn’t as happy as people imagine.	6
国会拨款两百万英镑作为防治水灾之用。	guóhuì bōkuǎn liǎng bǎiwàn Yīngbàng zuòwéi fángzhì shuǐzāi zhī yòng	Parliament appropriated two million pounds for flood control.	6
大多数松木燃烧时都发出断裂声。	dàduōshù sōngmù ránshāo shí dōu fāchū duànliè shēng	Most pine snaps as it burns.	6
他们最後相互亲吻而分离。	tāmen zuìhòu xiānghù qīnwěn ér fēnlí	They exchanged a final kiss before parting.	6
火箭绕地球运行一周后返回基地。	huǒjiàn rào dìqiú yùnxíng yīzhōu hòu fǎnhuí jīdì	The rocket did one circuit of the earth and returned to base.	6
隽语一个简明，机智，常常似是而非的陈述	juànyǔ yī gè jiǎnmíng jīzhì chángcháng sìshì’érfēi de chénshù	A concise, clever, often paradoxical statement.	6
他走出法庭时耷拉著脑袋。	tā zǒuchū fǎtíng shí dāla zhe nǎodài	He had his head down as he walked out of the court.	6
阳光穿过棱镜时将分解成各种颜色。	yángguāng chuānguò léngjìng shí jiāng fēnjiě chéng gèzhǒngyánsè	The sunlight will break into different colors through a prism.	6
在进入喷嘴之前，蒸汽处于高压状态。	zài jìnrù pēnzuǐ zhīqián zhēngqì chǔyú gāoyā zhuàngtài	Prior to entering the nozzle, the steam is at high pressure.	6
她激情已逝， 无从心回意转。	tā jīqíng yǐ shì wúcóng xīn huí yì zhuàn	Nothing could rekindle her extinct passion.	6
茅屋用木杆搭成，上面以草席覆盖。	máowū yòng mùgān dā chéng shàngmian yǐ cǎo xí fùgài	The hut was made of poles covered with grass mats.	6
交付将立法议案交归委员会的行动	jiāofù jiāng lìfǎ yì’àn jiāo guī wěiyuánhuì de xíngdòng	The act of referring a legislative bill to committee.	6
他挥霍无度， 难怪总欠债。	tā huīhuòwúdù nánguài zǒng qiànzhài	His extravagance explains why he is always in debt.	6
据报道说这种疾病破坏中枢神经系统。	jùbàodào shuō zhèzhǒng jíbìng pòhuài zhōngshūshénjīngxìtǒng	It is reported that this disease attacks the central nervous system.	6
戴安娜在希腊罗马神话中是狩猎女神。	Dài’ānnà zài Xīlà Luómǎ shénhuà zhōng shì shòuliè nǚshén	Diana is the goddess of hunting in Greek and Latin mythology.	6
曲状物具有此种曲线形状的物体	qū zhuàngwù jùyǒu cǐ zhǒng qūxiàn xíngzhuàng de wùtǐ	Something having the general shape of this curve.	6
劫掠物，战利品战时取自敌人的战利品	jiélüè wù zhànlìpǐn zhànshí qǔ zì dírén de zhànlìpǐn	Plunder taken from an enemy in time of war.	6
入侵的军队将该城镇掠夺一空。	rùqīn de jūnduì jiāng gāi chéngzhèn lüèduó yīkōng	The town was pillaged by the invading army.	6
法国队开始时领先， 但中场休息前威尔士队已与之拉平。	Fǎguó duì kāishǐ shí lǐngxiān dàn zhōngchǎng xiūxi qián Wēi’ěrshì duì yǐ yǔ zhī lāpíng	France took an early lead but Wales drew level (ie equalized the score) before half-time.	6
那位妇人对找回被盗的珠宝感到非常高兴。	nà wèi fùrén duì zhǎohuí bèi dào de zhūbǎo gǎndào fēicháng gāoxìng	Th woman was delighted at the recovery of her stolen jewels.	6
临近终点时，那几匹马齐头并进，简直分不出先后。	línjìn zhōngdiǎn shí nà jǐ pǐ mǎ qítóubìngjìn jiǎnzhí fēn bù chū xiānhòu	As the horses raced towards the finishing post, there was nothing in it.	6
三层刺网一种三层竖向安置的渔网，由一层细目网夹在两层粗目网中构成	sān céng cì wǎng yīzhǒng sān céng shù xiàng ānzhì de yúwǎng yóu yīcéng xìmù wǎng jiā zài liǎng céng cū mù wǎng zhōng gòuchéng	A vertically set fishing net of three layers, consisting of a finely meshed net between two nets of coarse mesh.	6
船期交涉需15天，请更改延长信用证。	chuán qī jiāoshè xū tiān qǐng gēnggǎi yáncháng xìnyòngzhèng	Amend credit extend shipping negotiating date15 days.	6
这种肉已宣布不适宜人们食用。	zhèzhǒng ròu yǐ xuānbù bù shìyí rénmen shíyòng	The meat was condemned as unfit for human consumption.	6
西班牙曾以其强大的舰队而著称。	Xībānyá céng yǐ qí qiángdà de jiànduì ér zhùchēng	Spain used to be famous for its strong armada.	6
这个方程式中的x代表什麽？	zhège fāngchéngshì zhòngdì dàibiǎo shí mó	What does x represent in this equation?	6
低频扬声器设计用来再现低音频率的扬声器	dī pín yángshēngqì shèjì yònglái zàixiàn dīyīn pínlǜ de yángshēngqì	A loudspeaker designed to reproduce bass frequencies.	6
[谚]外表不可靠；不可专看表面现象。	yàn wàibiǎo bùkěkào bùkě zhuān kàn biǎomiàn xiànxiàng	Never judge from appearances.	6
目前正将医药用品空投到灾区。	mùqián zhèng jiāng yīyào yòngpǐn kōngtóu dào zāiqū	Medical supplies are being dropped to the stricken area.	6
总统抵达时， 检阅了仪仗队。	zǒngtǒng dǐdá shí jiǎnyuè le yízhàngduì	On his arrival the president inspected the guard of honour.	6
别瞎动电线线路， 你又不是电工。	bié xiā dòng diànxiàn xiànlù nǐ yòu bùshì diàngōng	Don’t meddle with the electrical wiring: you’re not an electrician.	6
艾奥宙斯所爱的少女，被赫拉变成丁小母牛	ài ào Zhòusī suǒ ài de shàonǚ bèi Hèlā biànchéng dīng xiǎo mǔ niú	A maiden who was loved by Zeus and transformed by Hera into a heifer.	6
倍数性一个细胞中染色体基本数目的倍数	bèishù xìng yī gè xìbāo zhōng rǎnsètǐ jīběn shǔ mùdì bèishù	A multiple of the basic number of chromosomes in a cell.	6
除了英语以外， 我们还学俄语及西班牙语。	chúle Yīngyǔ yǐwài wǒmen hái xué Éyǔ jí Xībānyáyǔ	Apart from English, we study Russian and Spanish.	6
古希腊人为爱神阿弗罗狄特造了许多神庙。	gǔ Xīlà rénwéi àishén ā fú luó dí tè zào le xǔduō shénmiào	The ancient Greek dedicated many shrines to Aphrodite.	6
世界各大强国均惟恐在军备竞赛中落後。	shìjiè gè dà qiángguó jūn wéikǒng zài jūnbèijìngsài zhōng luòhòu	The major world powers are afraid of falling behind in the arms race.	6
扭转，扭曲扭动的动作或实例；压挤或扭曲	niǔzhuǎn niǔqū niǔ dòng de dòngzuò huò shílì yājǐ huò niǔqū	The act or an instance of wringing; a squeeze or twist.	6
露头砖垂直而不是平行于墙根放置的砖块	lòutóu zhuān chuízhí ér bùshì píngxíng yú qiánggēn fàngzhì de zhuānkuài	A brick laid across rather than parallel with a wall.	6
利物浦队因对方一队员用手触球而得到一个罚球。	Lìwùpǔ duì yīn duìfāng yī duìyuán yòng shǒu chù qiú ér dédào yī gè fáqiú	Liverpool were given a penalty when one of their opponents handled the ball.	6
矿藏底石位于一个矿中金属矿藏之下的大量石头	kuàngcáng dǐ shí wèiyú yī gè kuàng zhōng jīnshǔ kuàngcáng zhīxià de dàliàng shítou	The mass of rock underlying a mineral deposit in a mine.	6
你们无谓将友情保密--其实已尽人皆知了。	nǐmen wúwèi jiāng yǒuqíng bǎomì qíshí yǐ jìn rén jiē zhīliǎo	It’s pointless trying to keep your friendship secret it’s common knowledge already.	6
用来分隔或组织计算机程序元素或数据元素的字符或字符串。例如括号、空格符、算术运算符、if（如果）、“BEGIN”等。	yònglái fēngé huò zǔzhī jìsuànjī chéngxù yuánsù huò shùjù yuánsù de zìfú huò zìfúchuàn lìrú kuòhào kònggé fú suànshù yùnsuàn fú rúguǒ děng	A string of one or more characters used to separate or organize elements of computer programs or data; for example, parentheses, blank character, arithmetic operator, if, “BEGIN”.	6
论点，主旨，主题标题当中显示出来的主题、论点或题材	lùndiǎn zhǔzhǐ zhǔtí biāotí dāngzhōng xiǎnshì chūlái de zhǔtí lùndiǎn huò tícái	A theme, an argument, or a subject indicated in a title.	6
候选人须 表明他们对单方面裁军所持的立场。	hòuxuǎnrén xū biǎomíng tāmen duì dānfāngmiàn cáijūn suǒ chí de lìchǎng	The candidates had to state their position on unilateral disarmament.	6
警察告诫围观者， 不要靠近燃烧　的建筑物。	jǐngchá gàojiè wéiguān zhě bùyào kàojìn ránshāo de jiànzhùwù	Police warned bystanders to keep away from the blazing building.	6
他因得宠而获此地位， 并非有何特长或本事。	tā yīn déchǒng ér huò cǐ dìwèi bìngfēi yǒu hé tècháng huò běnshì	He obtained his position more by favour than by merit or ability.	6
我能使用文字处理机， 但不了解其运转机制。	wǒ néng shǐyòng wénzì chǔlǐ jī dàn bù liǎojiě qí yùnzhuǎn jīzhì	I can use a word processor but I don’t understand its operation.	6
玩具销售额在圣诞节前夕达到最高峰， 现已逐渐下降。	wánjù xiāoshòu’é zài Shèngdànjié qiánxī dádào zuì gāofēng xiàn yǐ zhújiàn xiàjiàng	Toy sales peaked just before Christmas and are now decreasing.	6
终止于衰竭是“死亡”，但“圆满”却终止于无穷。	zhōngzhǐ yú shuāijié shì sǐwáng dàn yuánmǎn què zhōngzhǐ yú wúqióng	That which ends in exhaustion is death, but the perfect ending is in the endless.	6
梅子酱由干梅子或杏子做成的甜酱或油酥点心馅	méizi jiàng yóu gānméizi huò xìngzi zuò chéng de tián jiàng huò yóu sū diǎnxin xiàn	A sweet spread or pastry filling made of prunes or apricots.	6
锯缝，劈痕切割型工具如锯或斧子所制造的沟槽或凹口	jù féng pī hén qiēgē xíng gōngjù rú jù huò fǔzi suǒ zhìzào de gōu cáo huò āo kǒu	A groove or notch made by a cutting tool, such as a saw or an ax.	6
该药本身并无害处， 但与酒类同服则有危险。	gāi yào běnshēn bìng wúhài chǔ dàn yǔ jiǔ lèi tóng fú zé yǒu wēixiǎn	The drug is not harmful per se, but is dangerous when taken with alcohol.	6
黑曜岩火山玻璃，一般为黑色，带状，摔碎时色泽光亮，表面变曲，由火山熔岩迅速凝而成	hēi yào yán huǒshān bōli yībān wéi hēisè dài zhuàng shuāi suì shí sèzé guāngliàng biǎomiàn biàn qū yóu huǒshān róngyán xùnsù níng ér chéng	A usually black or banded, hard volcanic glass that displays shiny, curved surfaces when fractured and is formed by rapid cooling of lava.	6
裁减军备协议难以达成， 症结在於如何证实（如检查武器确已销毁）。	cáijiǎnjūnbèi xiéyì nányǐ dáchéng zhēngjié zàiyú rúhé zhèngshí rú jiǎnchá wǔqì què yǐ xiāohuǐ	Verification (eg Checking that weapons have been removed) could be an obstacle to an arms agreement.	6
金钱不是一切。	jīnqián bùshì yīqiè	Money isn’t everything.	6
我国每四年一次人口普查。	wǒguó měi sì nián yīcì rénkǒupǔchá	The census is taken one time every four years in our country.	6
一花独放不是春，百花齐放春满园。	yī huā dú fàng bùshì chūn bǎihuāqífàng chūn mǎn yuán	A single flower does not make a spring.	6
金钱买不来幸福。	jīnqián mǎi bù lái xìngfú	Money can’t buy happiness.	6
把这些捣乱分子赶出去。	bǎ zhèxiē dǎoluàn fēnzǐ gǎn chūqù	Let’s pitch out the troublemakers.	6
嘿，这个消息太棒了！	hēi zhège xiāoxi tài bàng le	Hey, the news’s terrific/great！	6
老百姓反对这种想法。	lǎobǎixìng fǎnduì zhèzhǒng xiǎngfǎ	The man in the street is opposed to this idea.	6
花发出一阵幽香。	huā fāchū yīzhèn yōuxiāng	The flowers gave off a fragrant odor.	6
我要为此干杯。	wǒ yào wèicǐ gānbēi	I’ll drink to that.	6
他们一家常在树林里野餐。	tāmen yījiā cháng zài shùlín lǐ yěcān	Their family often picnics in the woods.	6
文件每日存取， 使之不断更新。	wénjiàn měirì cúnqǔ shǐ zhī bùduàn gēngxīn	The files were accessed every day to keep them up to date.	6
不要过份相信陌生人。	bùyào guòfèn xiāngxìn mòshēngrén	Don’t be too confidential with strangers.	6
对。。。匆匆一看，一瞥	duì cōngcōng yī kàn yīpiē	Take a glance of...	6
他常带着一个酒葫芦。	tā cháng dài zhe yī gè jiǔ húlu	He always takes a wine gourd.	6
烟火炸开放出一阵火花。	yānhuǒ zhá kāifàng chū yīzhèn huǒhuā	The firework exploded in a shower of sparks.	6
输入中有好几处错误。	shūrù zhōng yǒu hǎojǐ chǔ cuòwù	There are several errors in the input.	6
过马路时要当心。	guòmǎlù shí yào dāngxīn	Be careful when you cross the road.	6
这个花园直伸展到河岸。	zhège huāyuán zhí shēnzhǎn dào hé’àn	The garden extends to the river bank.	6
他们恰在发洪水之前离开， 走得真是时候。	tāmen qià zài fā hóngshuǐ zhīqián líkāi zǒu dé zhēnshi shíhou	Their departure just before the floods was providential.	6
这种思想只能把世人引入歧途。	zhèzhǒng sīxiǎng zhǐnéng bǎ shìrén yǐnrù qítú	Such ideas will only lead the world’s people astray.	6
别为这些琐事生气。	bié wéi zhèxiē suǒshì shēngqì	Don’t be angry over such trivial matters.	6
人们正排队买票。	rénmen zhèng páiduì mǎi piào	People are queuing to buy tickets.	6
酷热使池水干枯。	kùrè shǐ chí shuǐ gānkū	The intense heat has dried up the pond.	6
对于这项建议，五人投票赞成，八人反对，两人弃权。	duìyú zhè xiàng jiànyì wǔ rén tóupiào zànchéng bā rén fǎnduì liǎng rén qìquán	Five members voted for the proposal, eight voted against, and two abstained.	6
这些袋子难於搬运， 倒不是因为重而是体积太大。	zhèxiē dàizi nán yú bānyùn dǎo bùshì yīnwèi zhòng érshì tǐjī tài dà	It’s not their weight that makes these sacks hard to carry, it’s their bulk.	6
不要试图掩盖错误。	bùyào shìtú yǎngài cuòwù	Do not try to cover a mistake.	6
｀黑寡妇＇马下一场比赛赢定了。	hēi guǎfu mǎ xià yī chǎng bǐsài yíng dìng le	Black Widow is a (dead) cert for (ie is sure to win) the next race.	6
他们担心河流会发洪水。	tāmen dānxīn héliú huì fā hóngshuǐ	They were fearful that the river would flood.	6
水能溶解盐。	shuǐnéng róngjiě yán	Water dissolves salt.	6
这银花瓶上刻有花卉浮雕图案。	zhè yín huāpíng shàng kè yǒu huāhuì fúdiāo tú’àn	The silver vase is embossed with a design of flower.	6
新住宅区紧接高速公路。	xīn zhùzháiqū jǐnjiē gāosùgōnglù	The new housing estate borders on the motorway.	6
他们正用水灌溉土地。	tāmen zhèngyòng shuǐ guàngài tǔdì	They are irrigating with water.	6
这张支票凭身分证件兑现。	zhè zhāng zhīpiào píng shēnfènzhèng jiàn duìxiàn	The cheque will be cashed on proof of identity.	6
不要动不动就挑毛病。	bùyào dòngbudòng jiù tiāomáobìng	Don’t be so ready to find fault.	6
烟囱里冒出来团团黑烟。	yāncōng lǐ mào chūlái tuán tuán hēi yān	Volumes of black smoke poured fromthe chimney.	6
乐曲接近高潮。	yuèqǔ jiējìn gāocháo	The music approached a climax.	6
把沙司搅拌一下以免结块。	bǎ shā sī jiǎobàn yīxià yǐmiǎn jié kuài	Stir the sauce to prevent it lumping.	6
这种植物终年常青。	zhèzhǒng zhíwù zhōngnián chángqīng	This plant has green leaves throughout the year.	6
他们为远征治装。	tāmen wéi yuǎnzhēng zhìzhuāng	They equipped themselves for the expedition.	6
他们全都惊讶地瞪着眼。	tāmen quándōu jīngyà dì dèng zhuóyǎn	They all stared with astonishment.	6
这名伤员由于失血过多而昏迷不醒。	zhè míng shāngyuán yóuyú shīxuè guòduō ér hūnmíbùxǐng	This wounded soldier was unconscious from his loss of blood.	6
【谚】智者热爱真理，愚者回避真理。	yàn zhìzhě rè’ài zhēnlǐ yú zhě huíbì zhēnlǐ	Wise men love truth, whereas fools shun it.	6
部长忙于重要国务。	fànrén chèn zhe tiānhēi táopǎo le	The minister is busy with important affairs of state.	6
本人认为此案证据不足。	běnrén rènwéi cǐ àn zhèngjù bùzú	The case, I would submit, is not proven.	6
班上计划义卖糖果，推选凯特为主持人。	bānshàng jìhuà yìmài tángguǒ tuīxuǎn kǎi tèwèi zhǔchírén	The class planned a candy sale and they elected Kate to head it up.	6
他们约定不久见面。	tāmen yuēdìng bùjiǔ jiànmiàn	They made a date to meet soon.	6
更改小小的改变，调正或限制	gēnggǎi xiǎoxiǎo de gǎibiàn diào zhèng huò xiànzhì	A small alteration, adjustment, or limitation.	6
姑不论胜负， 这场比赛想必十分精彩。	gū bùlùn shèngfù zhè chǎng bǐsài xiǎngbì shífēn jīngcǎi	Win or lose, it should be a very good match.	6
小溪突然转向东流。	xiǎoxī tūrán zhuǎnxiàng dōng liú	The stream takes a sudden bend to the east.	6
此人极其狂妄自大。	cǐ rén jíqí kuángwàngzìdà	The man’s full of conceit.	6
好书未必畅销。	hǎo shū wèibì chàngxiāo	A good book does not necessarily sell well.	6
把这个混合物充分摇匀。	bǎ zhège hùnhéwù chōngfèn yáoyún	Shake the mixture well.	6
这名罪犯被判处一年监禁。	zhè míng zuìfàn bèi pànchǔ yī nián jiānjìn	The criminal was sentenced to one year’s imprisonment.	6
这些石油将被精炼。	zhèxiē shíyóu jiāng bèi jīngliàn	The oil will be refined.	6
本人对案情陈述完毕。	běnrén duì ànqíng chénshù wánbì	I rest my case.	6
敌人被迫撤退。	dírén bèipò chètuì	The enemy was forced to retreat.	6
久旱使青草枯萎。	jiǔ hàn shǐ qīngcǎo kūwěi	The long drought scorched the grass.	6
经过长时间包围之后，这个小镇已被起义军攻克。	jīngguò cháng shíjiān bāowéi zhīhòu zhège xiǎo zhèn yǐ bèi qǐyì jūn gōngkè	After a prolonged siege, the town was rendered up to the insurgents.	6
我们虽算不上关系密切， 但还常见面。	wǒmen suī suàn bù shàng guānxìmìqiè dàn hái chángjiàn miàn	We’re not exactly on intimate terms, but we see each other fairly often.	6
信用证凭汇票付款。	xìnyòngzhèng píng huìpiào fùkuǎn	L/c is payable against your draft.	6
酒吧对外营业。	jiǔbā duìwài yíngyè	The bar is open to non-residents.	6
大风扫过平原。	dàfēng sǎo guò píngyuán	The wind whipped across the plain.	6
愿上帝拯救我们脱离罪恶。	yuàn Shàngdì zhěngjiù wǒmen tuōlí zuì’è	May God deliver us from evil.	6
新工厂将於三月份投产。	qǐng nǐ chǎnshù zhè yī lǐlùn xíng ma	The new plant comes on stream in March.	6
小商店受到大型超级市场不断排挤。	xiǎo shāngdiàn shòudào dàxíng chāojíshìchǎng bùduàn páijǐ	Small shops are being crowded out by the big supermarkets.	6
礁石外深色水域分界线	tā de xīn zhe jiāng yú chūnjì wènshì	A line of darker water beyond the reef.	6
那个流浪乞丐乔装得同侦探一样。	nàge liúlàng qǐgài qiáozhuāng dé tóng zhēntàn yīyàng	The tramp was none other than a detective in disguise.	6
这种食品应低温保存。	zhèzhǒng shípǐn yīng dīwēn bǎocún	The food should be kept at low temperature.	6
拐弯之前别忘记指示车行方向。	guǎiwān zhīqián bié wàngjì zhǐshì chēháng fāngxiàng	Don’t forget to indicate before turning.	6
桥已毁坏， 我们无法过河。	qiáo yǐ huǐhuài wǒmen wúfǎ guò hé	The bridge was destroyed so we couldn’t get across (ie cross) the river.	6
我们有权搜查这座建筑物。	wǒmen yǒuquán sōuchá zhè zuò jiànzhùwù	We have the authority to search this building.	6
桃儿容易碰伤--要轻拿轻放。	táo r róngyì pèng shāng yào qīng ná qīng fàng	Don’t drop the peaches they bruise easily.	6
又名，亦称	yòumíng yìchēng	Also known as.	6
注射为了医学目的通过血管将一种溶液注入体内	zhùshè wèile yīxué mùdì tōngguò xuèguǎn jiāng yīzhǒng róngyè zhùrù tǐnèi	Introduction of a solution into the body through a vein for therapeutic purposes.	6
耶稣以比喻教导。	Yēsū yǐ bǐyù jiàodǎo	Jesus taught in parables.	6
不要对结果妄加猜测。	bùyào duì jiéguǒ wàng jiā cāicè	Don’t conjecture about the outcome.	6
大多数植物靠种子繁殖。	dàduōshù zhíwù kào zhǒngzi fánzhí	Most plants propagate by seed.	6
剃刀锋利刮得就乾净。	tìdāo fēnglì guā dé jiù gān jìng	A sharp razor gives a close shave.	6
天气预报之後即为6点钟报时信号。	tiānqìyùbào zhīhòu jíwéi diǎnzhōng bàoshí xìnhào	The weather forecast is followed by the pips at 6 o’clock.	6
这种材料防雨。	zhèzhǒng cáiliào fáng yǔ	This material is impervious to rainwater.	6
使用所附涂敷器涂用胶水。	shǐyòng suǒ fù túfū qì tú yòng jiāoshuǐ	Use the applicator provided to spread the glue.	6
市价已见回升，仓促处理掉，不足为取。	shìjià yǐ jiàn huíshēng cāngcù chǔlǐ diào bùzú wéi qǔ	Hurried disposal unadvisable market recovery envisage.	6
有些广告毫无吸引力。	yǒuxiē guǎnggào háowú xīyǐnlì	Some advertisements have no pull at all.	6
湖被树木环绕。	hú bèi shùmù huánrào	The lake is encircled by trees.	6
这些规定仅适用于儿童。	zhèxiē guīdìng jǐn shìyòng yú értóng	This regulation refers only to children.	6
这种声明具有政治性质。	zhèzhǒng shēngmíng jùyǒu zhèngzhì xìngzhì	The statements were of political character.	6
这些设施使全城受益。	zhèxiē shèshī shǐ quánchéng shòuyì	These facilities have benefited the whole town.	6
董事会决定大规模生产这种汽车。	dǒngshìhuì juédìng dàguīmó shēngchǎn zhèzhǒng qìchē	The board of directors made the decision to produce the car on a large scale.	6
树叶使光线漫射。	shùyè shǐ guāngxiàn màn shè	The light was diffused by the leaves.	6
那事无丝毫真实性。	nà shì wú sīháo zhēnshíxìng	There isn’t a grain of (ie any) truth in it.	6
英国政府对这些报道不予证实。	Yīngguó zhèngfǔ duì zhèxiē bàodào bùyú zhèngshí	Whitehall is/are refusing to confirm the reports.	6
人民反对专制。	rénmín fǎnduì zhuānzhì	The people resist despotism.	6
他们互相争吵。	tāmen hùxiāng zhēngchǎo	They quarreled among themselves.	6
那位官员必须免职。	nà wèi guānyuán bìxū miǎnzhí	That officer must be removed.	6
那支熊已完全发育成熟。	nà zhī xióng yǐ wánquán fāyù chéngshú	The bear was a fully grown adult.	6
他们决定夜晚进攻。	tāmen juédìng yèwǎn jìngōng	They decided to attack at night.	6
知识分子决不应结婚；他们既不会享受婚姻生活，更不应复制自己。	zhīshifènzǐ juébù yīng jiéhūn tāmen jì bùhuì xiǎngshòu hūnyīn shēnghuó gèng bù yīng fùzhì zìjǐ	Intellectual shall never marry; they will not enjoy it, and besides, they shall not reproduce themselves.	6
振作起来，面对冲击！	zhènzuò qilai miànduì chōngjī	Brace yourself for a shock！	6
反复呼喊抗议口号	fǎnfù hūhǎn kàngyì kǒuhào	Chanted defiant slogans.	6
内幕消息；内部笑话	nèimù xiāoxi nèibù xiàohuà	Inside information; an inside joke.	6
他们是否按体积计算运费？	tāmen shìfǒu àn tǐjī jìsuàn yùnfèi	Do they charge carriage by bulk?	6
现今人们越来越依赖计算机协助工作。	xiànjīn rénmen yuèláiyuè yīlài jìsuànjī xiézhù gōngzuò	Nowadays we rely increasingly on computers for help/to help us.	6
我们正给浴室贴壁纸。	wǒmen zhèng gěi yùshì tiē bìzhǐ	We’re papering the bathroom.	6
把词典时时 放在手边。	bǎ cídiǎn shíshí fàng zài shǒubiān	Keep your dictionary ready (to hand) at all times.	6
贫富不均可造成社会动荡。	pínfù bù jūnkě zàochéng shèhuì dòngdàng	Inequalities in wealth cause social unrest.	6
倘若外援枯竭，形势将极为严重。	tǎngruò wàiyuán kūjié xíngshì jiāng jíwéi yánzhòng	If foreign aid dries up the situation will be desperate.	6
军人必须服从命令。	jūnrén bìxū fúcóng mìnglìng	Soldiers must obey orders.	6
行列行、列、系列或行列	hángliè xíng liè xìliè huò hángliè	A row, line, series, or range.	6
领导人互相寒暄一番， 然後开始谈判。	lǐngdǎorén hùxiāng hánxuān yī fān ránhòu kāishǐ tánpàn	After an exchange of pleasantries, the leaders started their negotiations.	6
中央C音相当於每秒钟振动256次。	zhōngyāng yīn xiāngdāng yú měi miǎozhōng zhèndòng cì	Middle C is equivalent to 256 vibrations per second.	6
这些争论彼此势均力敌。	zhèxiē zhēnglùn bǐcǐ shìjūnlìdí	These arguments cancel each other out.	6
这台机器把麦子磨成面粉。	zhè tái jīqì bǎ màizi mó chéng miànfěn	This machine crushes wheat grain to make flour.	6
最近供暖设备已稍加改动以提高效率。	zuìjìn gōng nuǎn shèbèi yǐ shāo jiā gǎidòng yǐ tígāo xiàolǜ	The heating system has recently been modified to make it more efficient.	6
粥有益于消化。	zhōu yǒuyì yú xiāohuà	Porridge is good for digestion.	6
把塞子拔掉。	bǎ sāizi bádiào	Pull the plug out.	6
握手时软弱无力。	wòshǒu shí ruǎnruò wúlì	Has limp, weak handshake.	6
金属遇热则膨胀。	jīnshǔ yù rè zé péngzhàng	Metals expand when they are heated.	6
燕子以虫为食。	yànzi yǐ chóng wéi shí	Swallows are insectivorous.	6
一名现场采访记者	yī míng xiànchǎng cǎifǎngjìzhě	An on-the-scene reporter.	6
遇火灾时按下此钮。	yù huǒzāi shí ànxià cǐ niǔ	Press this button in case of fire.	6
渔夫用矛作为武器。	yúfū yòng máo zuòwéi wǔqì	The fisher used a spear as his weapon.	6
村民一致反对修建旁道。	cūnmín yīzhì fǎnduì xiūjiàn páng dào	The villagers are unanimous in their opposition to the building of a bypass.	6
我们将迁往纽卡斯尔南部。	wǒmen jiāng qiān wǎng Niǔkǎsī’ěr nánbù	We’re relocating just south of Newcastle.	6
前景似颇暗淡，但我们仍满怀希望。	qiánjǐng sì pō àndàn dàn wǒmen réng mǎnhuái xīwàng	The future looks rather gloomy, but we live in hope.	6
街道十分拥挤， 汽车无法通行。	jiēdào shífēn yōngjǐ qìchē wúfǎ tōngxíng	The street was so crowded that cars were unable to pass.	6
若肾功能衰退， 可通过渗透作用使血液净化。	ruò shèngōngnéng shuāituì kě tōngguò shèntòu zuòyòng shǐ xuèyè jìnghuà	Blood can be cleaned by osmosis if the kidneys have failed.	6
闪电通常伴有雷声。	shǎndiàn tōngcháng bànyǒu léishēng	Lightning usually accompanies thunder.	6
总经理由董事会任命。	zǒngjīnglǐ yóu dǒngshìhuì rènmìng	The president is appointed by the board of directors.	6
这位顾客将为此恶劣服务诉诸法律。	zhèwèi gùkè jiāng wèicǐ èliè fúwù sùzhū fǎlǜ	The customer will go to law for the bad service.	6
米基曾因毒品事而被捕。	mǐ jī céng yīn dúpǐn shì ér bèibǔ	Mickey’s been busted for drugs.	6
窗户碎成碎片。	chuānghu suì chéng suìpiàn	The window broke into pieces.	6
总数为10英镑。	zǒngshù wéi Yīngbàng	The total works out at 10.	6
基督降世拯救我们摆脱罪恶。	Jīdū jiàngshì zhěngjiù wǒmen bǎituō zuì’è	Jesus Christ came into the world to save us from our sins.	6
决议案获一致通过。	juéyì’àn huò yīzhì tōngguò	The resolution was carried nem con.	6
建议肥胖病人改变饮食。	jiànyì féipàng bìngrén gǎibiàn yǐnshí	Obese patients are advised to change their diet.	6
入侵者把村镇变为废墟。	rùqīnzhě bǎ cūnzhèn biànwéi fèixū	The invader laid towns and villages in ruins.	6
（城市）上空烟雾弥漫。	chéngshì shàngkōng yānwù mímàn	Smog hung in the sky (over the city).	6
侦探特别强调细节。	zhēntàn tèbié qiángdiào xìjié	The detective laid great stress on details.	6
英格兰队某些主力运动员受伤而使攻球削弱。	Yīnggélán duì mǒuxiē zhǔlì yùndòngyuán shòushāng ér shǐ gōng qiú xuēruò	England’s attack has been weakened by the injury of certain key players.	6
对市场动态，烦告货主意向如何？	duì shìchǎng dòngtài fán gào huò zhǔ yìxiàng rúhé	Advise how shipper dispose towards market movement?	6
艾伯塔平原极其肥沃。	Àibótǎ píngyuán jíqí féiwò	The plains of Alberta are extremely fertile.	6
政府派警方出动恢复治安。	zhèngfǔ pài jǐngfāng chūdòng huīfù zhì’ān	The government ordered the police out to restore order in the streets.	6
违反一项合同；侵犯专利权	wéifǎn yī xiàng hétong qīnfàn zhuānlìquán	Infringe a contract; infringe a patent.	6
如此痛切而清晰！	rúcǐ tòng qiē ér qīngxī	Burst agonized and clear！	6
政府将制定法规限制枪支出售。	zhèngfǔ jiāng zhìdìng fǎguī xiànzhì qiāngzhī chūshòu	The government will introduce legislation to restrict the sale of firearms.	6
电力供应中断，城市陷于混乱之中。	diànlì gōngyìng zhōngduàn chéngshì xiànyú hùnluàn zhīzhōng	After the failure of the electricity supplies the city was in chaos.	6
熊熊烈火席卷森林。	xióngxióng lièhuǒ xíjuǎn sēnlín	Billows of flame swept through the forest.	6
闪电总与雷鸣相伴。	shǎndiàn zǒng yǔ léimíng xiāngbàn	Lightening is usually accompanied by thunder.	6
驾驶员减低速度。	jiàshǐyuán jiǎndīsùdù	The driver lessened his speed.	6
军士长命令士兵靠拢。	jūnshì cháng mìnglìng shìbīng kàolǒng	The sergeant-major ordered the men to close up.	6
管理部门将供应饮食。	guǎnlǐ bùmén jiāng gōngyìng yǐnshí	The management will provide food and drink.	6
谈判陷入僵局。	tánpàn xiànrù jiāngjú	The negotiations have reached a deadlock.	6
革命者计划推翻傀儡政府。	gémìng zhě jìhuà tuīfān kuǐlěi zhèngfǔ	The revolutionist planned to overturn this puppet regime.	6
总统生病时， 其职务交由副总统代理。	zǒngtǒng shēngbìng shí qí zhíwù jiāo yóu fùzǒngtǒng dàilǐ	When the President is ill, his duties devolve upon the Vice-President.	6
专制如同或被专制者统治；绝对权力或权威	zhuānzhì rútóng huò bèi zhuānzhì zhě tǒngzhì juéduì quánlì huò quánwēi	Rule by or as if by a despot; absolute power or authority.	6
侵占，泛滥，超过限度	qīnzhàn fànlàn chāoguòxiàndù	An act of overrunning.	6
空气中烟雾弥漫。	kōngqì zhōng yānwù mímàn	The air was thick with smoke.	6
警方仍然控制著局势。	jǐngfāng réngrán kòngzhì zhe júshì	The police retained control of the situation.	6
危险驾驶应受严惩。	wēixiǎn jiàshǐ yīng shòu yánchéng	Dangerous driving should be severely punished.	6
把 1。90 英镑的费用上调为整数 2 英镑， 把 3。10 英镑下调为整数 3 英镑。	bǎ Yīngbàng de fèiyòng shàngtiáo wéi zhěngshù Yīngbàng bǎ Yīngbàng xiàdiào wéi zhěngshù Yīngbàng	A charge of 1.90 will be rounded up to 2, and one of 3.10 rounded down to 3.	6.037
纽卡斯尔英格兰中西部的一个市级自治区，位于斯图克西南偏南。拥有制砖业、制瓦业和纺织服装工业。人口74，200	Niǔkǎsī’ěr Yīnggélán zhōngxībù de yī gè shì jí zìzhìqū wèiyú sī túkè xīnán piān nán yōngyǒu zhì zhuān yè zhì wǎ yè hé fǎngzhī fúzhuāng gōngyè rénkǒu	A municipal borough of west-central England south-southwest of Stoke. It has brick, tile, and clothing industries. Population, 74,200.	6.045
贝特，汉斯·阿尔布雷希生于1906德裔美籍物理学家。因其对恒星能量产生的研究而获1967年诺贝尔奖	bèi tè Hànsī ā ěr bùléi xī shēng yú dé yì Měijí wùlǐxuéjiā yīn qí duì héngxīng néngliàng chǎnshēng de yánjiū ér huò nián Nuòbèi’ěr Jiǎng	German-born American physicist. He won a1967 Nobel Prize for research on the energy production of stars.	6.045
卡祖笛一种当吹奏者向吹口处低吟或哼唱时一个膜能够发出声音的玩具乐器	kǎ zǔ dí yīzhǒng dāng chuīzòu zhě xiàng chuī kǒu chǔ dī yín huò hēngchàng shí yī gè mó nénggòu fāchū shēngyīn de wánjù yuèqì	A toy instrument with a membrane that produces a sound when a player hums or sings into the mouthpiece.	6.056
若时机不当， 一言不慎， 可能毁掉整个计画。	ruò shíjī bùdàng yīyán bùshèn kěnéng huǐdiào zhěnggè jìhuà	One indiscreet remark at the wrong moment could ruin the whole plan.	6.067
这个国家连年战争元气尽失後， 已开始慢慢恢复正常状态。	zhège guójiā liánnián zhànzhēng yuánqì jìn shī hòu yǐ kāishǐ mànmàn huīfù zhèngcháng zhuàngtài	The country, prostrate after years of war, began slowly to recover.	6.067
尽管计划度假时兴致勃勃， 而到头来假日本身却颇为扫兴。	jǐnguǎn jìhuà dùjià shí xìngzhìbóbó ér dàotóulái jiàrì běnshēn què pōwéi sǎoxìng	The holiday itself was rather an anticlimax after all the excitement of planning it.	6.067
一晚放映三个同一主题的访问记实， 真是小题大做。	yī wǎn fàngyìng sān gè tóngyī zhǔtí de fǎngwèn jì shí zhēnshi xiǎotídàzuò	It was surely overkill to screen three interviews on the same subject in one evening.	6.071
若不付费用， 就要停止供应电力[煤气]。	ruò bù fù fèiyòng jiùyào tíngzhǐ gōngyìng diànlì méiqì	If you don’t pay your bills they’ll disconnect your electricity/gas.	6.071
保母抱著个孩子进来， 孩子身上裹著暖暖的毯子。	bǎomǔ bào zhe gè háizi jìnlái háizi shēnshang guǒ zhe Nuǎnnuǎn de tǎnzi	The nurse carried in a baby wrapped (up) in a warm blanket.	6.071
风暴带有强风或狂风但很少或几乎无雨的一种风暴	fēngbào dàiyǒu qiángfēng huò kuángfēng dàn hěn shǎo huò jīhū wú yǔ de yīzhǒng fēngbào	A storm with high winds or violent gusts but little or no rain.	6.077
这些拖拉机均具有结构紧凑，操纵简便，转向灵活，耗油省等特点。	zhèxiē tuōlājī jūn jùyǒu jiégòu jǐncòu cāozòng jiǎnbiàn zhuǎnxiàng línghuó hào yóu shěng děng tèdiǎn	The tractors are featured by compact construction, convenient operation, high maneuverability and low fuel consumption.	6.077
空中交叉跳跃一种芭蕾舞动作，舞者在空中多次前后交叉双腿	kōngzhōng jiāochā tiàoyuè yīzhǒng bālěiwǔ dòngzuò wǔzhě zài kōngzhōng duōcì qiánhòu jiāochā shuāngtuǐ	A jump in ballet during which the dancer crosses the legs a number of times, alternately back and forth.	6.077
地雷，水雷一种用来摧毁敌军部队、船舰、碉堡或装备的爆破装置，通常安放在隐蔽处，由于接触、靠近或定时而引爆	dìléi shuǐléi yīzhǒng yònglái cuīhuǐ díjūn bùduì chuánjiàn diāobǎo huò zhuāngbèi de bàopò zhuāngzhì tōngcháng ānfàng zài yǐnbì chǔ yóuyú jiēchù kàojìn huò dìngshí ér yǐnbào	An explosive device used to destroy enemy personnel, shipping, fortifications, or equipment, often placed in a concealed position and designed to be detonated by contact, proximity, or a time fuse.	6.08
分期付的款可於每月最後一日交付。	fēnqī fù díkuǎn kě yú měiyuè zuìhòu yī rì jiāofù	Instalments are payable on the last day of the month.	6.083
保守党在上次议会选举中从工党手里夺得这个议席。	bǎoshǒudǎng zài shàngcì yìhuì xuǎnjǔ zhōng cóng gōngdǎng shǒulǐ duódé zhège yìxí	The Conservatives won the seat (ie in Parliament) from Labour at the last election.	6.083
她一见路上有个小孩， 便猛踩刹车。	tā yī jiàn lùshang yǒu gè xiǎohái biàn měng cǎishāchē	As soon as she saw the child in the road, she jammed on her brakes.	6.083
由於炸弹过早爆炸， （恐怖分子的）阴谋未能得逞。	yóuyú zhàdàn guòzǎo bàozhà kǒngbùfènzǐ de yīnmóu wèinéng déchěng	The plot backfired (on the terrorist) when the bomb exploded too soon.	6.083
协议中有一条规定， 承租人负担建筑物的修理费。	xiéyì zhōng yǒu yī tiáo guīdìng chéngzūrén fùdān jiànzhùwù de xiūlǐ fèi	A clause in the agreement provides that the tenant shall pay for repairs to the building.	6.083
多佛尔与法国加莱市隔岸相对的英格兰东南部自治市，临多佛尔海峡。罗马灯塔遗址，自中世纪以来就是战略要地，该市白垩崖多岩洞和涵洞原为走私者所用。人口33，700	Duōfó’ěr yǔ Fǎguó jiā lái shì gé àn xiāngduì de Yīnggélán dōngnánbù zìzhìshì lín Duōfó’ěr hǎixiá Luómǎ dēngtǎ yízhǐ zì zhōngshìjì yǐlái jiùshì zhànlüè yàodì gāi shì bái’è yá duō yán dòng hé hándòng yuán wéi zǒusī zhě suǒ yòng rénkǒu	A municipal borough of southeast England on the Strait of Dover opposite Calais, France. Site of a Roman lighthouse, it has been a strategic port since medieval times. The chalk cliffs rising above the city have caves and tunnels originally used by smugglers. Population, 33,700.	6.086
黄铜制品用这种合金制的装饰品、物件或器皿	huángtóng zhìpǐn yòng zhèzhǒng héjīn zhì de zhuāngshìpǐn wùjiàn huò qìmǐn	Ornaments, objects, or utensils made of this alloy.	6.091
那轮船颠簸摇晃， 很多乘客头晕恶心。	nà lúnchuán diānbǒ yáohuàng hěn duō chéngkè tóuyūn ěxīn	The ship pitched and rolled and many passengers were sick.	6.091
牟利罗，巴托洛米奥·埃斯特巴1617－1682西班牙风俗、肖像和宗教题材的画家，比如圣灵怀胎1668	móulì luó bā tuō Luò mǐ ào āi sī tè bā Xībānyá fēngsú xiàoxiàng hé zōngjiào tícái de huàjiā bǐrú Shènglíng huáitāi	Spanish painter of genre scenes, portraits, and religious subjects, such as Immaculate Conception(1668).	6.091
消防队员需用呼吸器械才能进入燃烧著的房屋。	xiāofángduìyuán xū yòng hūxī qìxiè cáinéng jìnrù ránshāo zhe de fángwū	Firemen needed breathing apparatus to enter the burning house.	6.091
假若认为耳聋有趣， 这种幽默感十分不当。	jiǎruò rènwéi ěrlóng yǒuqù zhèzhǒng yōumògǎn shífēn bùdàng	If you think deafness is funny, you’ve got a very misplaced sense of humour.	6.091
总统最近死後， 酝酿著一场军事政变。	zǒngtǒng zuìjìn sǐhòu yùnniàng zhe yī chǎng jūnshìzhèngbiàn	The president’s recent death set the stage for a military coup.	6.091
先把黄油融化， 然後加入面粉。	xiān bǎ huángyóu rónghuà ránhòu jiārù miànfěn	Melt the butter and then blend in the flour.	6.091
这些症状（照你看来）像是什麽病？	zhèxiē zhèngzhuàng zhào nǐ kànlai xiàng shì shí mó bìng	Which illness do these symptoms suggest (to you)?	6.1
金属门猛一关上时发出　光的响声。	jīnshǔ mén měng yī guānshàng shí fāchū guāng de xiǎngshēng	The metal door rang as it slammed shut.	6.1
这次选举後该党已沦为微不足道的少数党。	zhè cì xuǎnjǔ hòu gāi dǎng yǐ lúnwéi wēibùzúdào de shǎoshù dǎng	The election reduced the Party to a rump.	6.1
他散布流言蜚语危害很大， 事後才真相大白。	tā sànbù liúyánfēiyǔ wēihài hěn dà shìhòu cái zhēnxiàngdàbái	His malicious gossip caused much mischief until the truth became known.	6.1
独裁统治者一个有着无限权利的统治者；专制者	dúcái tǒngzhìzhě yī gè yǒuzhe wúxiàn quánlì de tǒngzhìzhě zhuānzhì zhě	A ruler having unlimited power; a despot.	6.1
喜庆时节，欢庆盛会欢庆活动的时节或盛会	xǐqìng shíjié huānqìng shènghuì huānqìng huódòng de shíjié huò shènghuì	A season or an occasion of joyful celebration.	6.1
警方已排除该谋杀案中有抢劫的动机。	jǐngfāng yǐ páichú gāi móushā’àn zhōng yǒu qiǎngjié de dòngjī	The police have excluded robbery as a motive for the murder.	6.1
金疗法用金的化合物治疗某些疾病，如风湿性关节炎	jīn liáofǎ yòng jīn de huàhéwù zhìliáo mǒuxiē jíbìng rú fēngshīxìngguānjiéyán	The treatment of certain diseases, especially rheumatoid arthritis, with gold compounds.	6.1
直线AB与直线CD相交於E点。	zhíxiàn yǔ zhíxiàn xiāngjiāo yú diǎn	The lines AB and CD intersect at E.	6.1
这次聚会一定没意思--咱们想个法子别去了。	zhè cì jùhuì yīdìng méiyìsi zánmen xiǎng gè fǎzi bié qù le	It’s bound to be a boring party let’s try to wangle out of it/going.	6.1
在选举前后政客们总要许愿讨好民众。	zài xuǎnjǔ qiánhòu zhèngkè men zǒngyào xǔyuàn tǎohǎo mínzhòng	Politicians bid for popular favour around election time.	6.111
两个氢原子和一个氧原子结合而成一个水分子。	liǎng gè qīngyuánzǐ hé yī gè yǎngyuánzǐ jiéhé ér chéng yī gè shuǐ fēnzǐ	Two atoms of hydrogen combine with one atom of oxygen to form a molecule of water.	6.111
这只是玩具枪， 不能发射子弹。	zhè zhǐshì wánjùqiāng bùnéng fāshè zǐdàn	This is just a toy gun: it doesn’t shoot.	6.111
侦察员们分成两人一组，开始巡逻这一地区。	zhēncháyuán men fēnchéng liǎng rén yī zǔ kāishǐ xúnluó zhè yī dìqū	The scouts paired off and began to patrol the area.	6.111
那位胖妇人穿着金色的紧身礼服，显得滑稽可笑。	nà wèi pàng fùrén chuānzhuó jīnsè de jǐnshēn lǐfú xiǎnde huájī kěxiào	That fat woman looked ridiculous in her tight golden dress.	6.111
企业家要具备什麽素质才能出人头地？	qǐyèjiā yào jùbèi shí mó sùzhì cáinéng chūréntóudì	What qualities go to make a successful businessman?	6.111
很多黄金饰物回炉後铸成了金币。	hěn duō huángjīn shìwù huílú hòu zhù chéngle jīnbì	Many of the gold ornaments were melted down to be made into coins.	6.111
大屠杀大规模杀戮，如战争中的大屠杀；屠宰	dàtúshā dàguīmó shālù rú zhànzhēng zhòngdì dàtúshā túzǎi	Massive slaughter, as in war; a massacre.	6.111
卡车转弯时车上货物滑离了原位。	kǎchē zhuǎnwān shí chē shàng huòwù huá lí le yuánwèi	The lorry turned and its load slipped.	6.111
在圣诞节期间， 广告战已达到高潮。	zài Shèngdànjié qījiān guǎnggào zhàn yǐ dádào gāocháo	The advertising campaign reached a crescendo at Christmas.	6.111
美国外交政策取决于联邦政府，联邦法律由国会制定。	Měiguó wàijiāozhèngcè qǔjué yú liánbāngzhèngfǔ liánbāng fǎlǜ yóu guóhuì zhìdìng	In the USA foreign policy is decided by the federal government and federal laws are made by Congress.	6.111
我们轻声谈话， 以免吵醒婴儿。	wǒmen qīngshēng tánhuà yǐmiǎn chǎoxǐng yīng’ér	We spoke in whispers for fear of waking the baby/for fear (that) we might wake the baby.	6.111
根据规定， 申请者一律需经笔试。	gēnjùguīdìng shēnqǐng zhě yīlǜ xū jīng bǐshì	It is laid down that all applicants must sit a written exam.	6.111
手铲刀身尖突并呈铲状的小型器具，在种植植物时用来挖土	shǒu chǎn dāoshēn jiān tū bìng chéng chǎn zhuàng de xiǎoxíng qìjù zài zhòngzhí zhíwù shí yònglái wā tǔ	A small implement with a pointed, scoop-shaped blade used for digging, as in setting plants.	6.118
一枝步枪瞄准著人质的头。	yī zhī bùqiāng miáozhǔn zhe rénzhì de tóu	The hostage had a rifle levelled at his head.	6.125
《每日回声报》拥有读者逾一千万人。	měirì huíshēng bào yōngyǒu dúzhě yú yī qiānwàn rén	The Daily Echo has a readership of over ten million.	6.125
一个正直的法官不能一味顺从舆论。	yī gè zhèngzhí de fǎguān bùnéng yīwèi shùncóng yúlùn	An honest judge cannot be servile to public opinion.	6.125
那个傻孩子从来不做事，只是整天游手好闲。	nàge shǎ háizi cóngláibù zuòshì zhǐshì zhěngtiān yóushǒuhàoxián	That silly child never does anything; he just fools about all day long.	6.125
邮车每周只到这个偏僻的村庄一次。	yóuchē měizhōu zhǐ dào zhège piānpì de cūnzhuāng yīcì	Mail comes to this remote village only once a week.	6.125
那位大使预期他下次派驻巴黎。	nà wèi dàshǐ yùqī tā xiàcì pài zhù Bālí	The ambassador expects that his next posting will be (to) Paris.	6.125
这所学校每年招收六十名男女新生。	zhè suǒ xuéxiào měinián zhāoshōu liùshí míng nánnǚ xīnshēng	The school admits sixty new boys and girls every year.	6.125
解放前，各种捐税沉重地压在人民身上。	jiěfàng qián gèzhǒng juānshuì chénzhòng dì yā zài rénmín shēnshang	Before liberation, taxes weighed heavily upon the people.	6.125
他们穿著那种制服看起来怪模怪样的。	tāmen chuānzhuó nàzhǒng zhìfú kànqǐlái guàimóguàiyàng de	That uniform makes them look absurd.	6.125
摔下来的骑手遭飞奔马群践踏。	shuāi xiàlai de qí shǒu zāo fēibēn mǎqún jiàntà	Fallen riders were trampled underfoot by the charging horses.	6.125
法庭裁定那个人犯了侵犯人身罪。	fǎtíng cáidìng nàgèrén fàn le qīnfàn rénshēn zuì	The court determined that the man was guilty of assault.	6.125
射石炮早期发射石弹大炮的一种	shè shí pào zǎoqī fāshè shí tán dàpào de yīzhǒng	An early form of cannon that fired stone balls.	6.125
手电筒的光束扫遍屋内各个角落。	shǒudiàntǒng de guāngshù sǎo biàn wū nèi gègè jiǎoluò	The flashlight’s beam scanned every corner of the room.	6.125
这种橙汁饮品不含人工调味料。	zhèzhǒng chéngzhī yǐnpǐn bù hán réngōng tiáowèiliào	This orange drink contains no artificial flavourings.	6.125
这些鲜红色窗帘显得棕色地毯黯然失色。	gāi shū de quēdiǎn zàiyú zuòzhě wèinéng bǎ lùnzhèng zhǎnkāi	The bright red of the curtains kills the brown of the carpet.	6.125
渡船摇摇晃晃， 他感到恶心。	dùchuán yáo yáohuàng huàng tā gǎndào ěxīn	The sway of the ferry made him feel sick.	6.125
水银温度计停留在摄氏35度左右。	shuǐyín wēndùjì tíngliú zài Shèshì dù zuǒyòu	The mercury hovered around 35 Celsius degree.	6.125
昨夜温度计显示气温下降到零度。	zuóyè wēndùjì xiǎnshì qìwēn xiàjiàng dào língdù	The thermometer fell to zero lastnight.	6.125
玛丽·杜瓦尔夫人转交彼得·布朗先生。	Mǎlì dù wǎ ěr fūren zhuǎnjiāo Bǐdé Bùlǎng xiānsheng	Mr Peter Brown c/o Mme Marie Duval....	6.125
柱，杆建筑物框架中横梁的支撑物	zhù gān jiànzhùwù kuàngjià zhōng héngliáng de zhīchēng wù	A support for a beam in the framework of a building.	6.125
金属板锻造、轧制，或铸造而成的金属板	jīnshǔbǎn duànzào zházhì huò zhùzào ér chéng de jīnshǔbǎn	A sheet of hammered, rolled, or cast metal.	6.125
这些白线把赛区分成各个部分。	zhèxiē báixiàn bǎ sài qūfēn chéng gègè bùfen	White lines divide the playing area into sections.	6.125
这个计画因缺乏资金而难以实现。	zhège jìhuà yīn quēfá zījīn ér nányǐshíxiàn	The project was hamstrung by lack of funds.	6.125
这种病有两种情况: 第一， 由高血压引起; 第二。。。。	zhèzhǒng bìng yǒu liǎng zhǒng qíngkuàng dìyī yóu gāoxuèyā yǐnqǐ dì’èr	The illness can develop in two ways: firstly, in cases of high blood pressure and secondly...	6.125
这座山高而陡，形成一道岩石屏障。	zhè zuò shān gāo ér dǒu xíngchéng yīdào yánshí píngzhàng	The mountain rose up in a steep wall of rock.	6.125
冻鸡应彻底解冻後再烹调。	dòng jī yīng chèdǐ jiědòng hòu zài pēngtiáo	A frozen chicken should be allowed to defrost completely before cooking.	6.125
警方必须竭尽全力追捕罪犯，将他们绳之以法。	jǐngfāng bìxū jiéjìnquánlì zhuībǔ zuìfàn jiāng tāmen shéngzhīyǐfǎ	The police must do all they can to bring criminals to justice.	6.125
按此地址函索即免费寄奉样品。	àn cǐ dìzhǐ hán suǒ jí miǎnfèi jì fèng yàngpǐn	Write now to this address and we will send you a free sample by return.	6.125
编辑迅速将失事消息编入晚间新闻。	biānjí xùnsù jiāng shīshì xiāoxi biān rù wǎnjiān xīnwén	Editors rushed out a piece on the crash for the late news.	6.125
女士们、 先生们: 请别堵住通道。 谢谢诸位大力协助。	nǚshì men xiānsheng men qǐng bié dǔzhù tōngdào xièxie zhūwèi dàlì xiézhù	Please clear the gangways, ladies and gentlemen. Thank you for your co-operation.	6.133
方形物或方形地区大致呈正方形或正方体的地区、空间或物体	fāngxíng wù huò fāngxíng dìqū dàzhì chéng zhèngfāngxíng huò zhèngfāngtǐ de dìqū kōngjiān huò wùtǐ	An approximately square or cubic area, space, or object.	6.133
采摘物；采集量已采集或可被采集的物体或一群物体	cǎizhāi wù cǎijí liáng yǐ cǎijí huò kě bèi cǎijí de wùtǐ huò yī qún wùtǐ	Something or a group of things that are or may be picked.	6.133
她会说法语， 德语， 还会说一点儿俄语。	tā huì shuōfa yǔ Déyǔ hái huì shuō yīdiǎnr Éyǔ	She speaks French and German and also a little Russian.	6.143
那个疯子开车开得太快了。	nàge fēngzi kāichē kāi dé tài kuài le	That maniac drives far too fast.	6.143
这懒小子一整天一点事都没干。	zhè lǎn xiǎozi yī zhěngtiān yīdiǎn shì dōu méi gàn	The lazy boy has not done a stroke of work all day.	6.143
大树小树都已长出嫩芽。	Dàshù xiǎoshù dōu yǐ zhǎngchū nènyá	The trees and hedgerows are in bud.	6.143
一步行走时跨出的一步；一大步	yī bùxíng zǒu shí kuà chū de yī bù yī dàbù	A step made in walking; a stride.	6.143
这些蚕的吐丝量很大。	zhèxiē cán de tǔ sī liáng hěn dà	The silkworms are producing well.	6.143
鹿有些种类能脱换鹿角。	lù yǒuxiē zhǒnglèi néng tuōhuàn lùjiǎo	Some kinds of deer shed their horns.	6.143
我设法悄悄地行走，俾使他们听不见。	wǒ shèfǎ qiāoqiāo dì xíngzǒu bǐshǐ tāmen tīngbujiàn	I tried to walk quietly, so that they would not hear me.	6.143
内脏内部脏器，尤指大小肠；内脏	nèizàng nèibù zàngqì yóuzhǐ dàxiǎo cháng nèizàng	The internal organs, especially the intestines; viscera.	6.143
那位发言者遭到了连珠炮般的追问。	nà wèi fāyán zhě zāo dàoliǎo liánzhūpào bān de zhuīwèn	The speaker was bombarded with questions.	6.143
有些教师觉得课堂秩序很难维持。	yǒuxiē jiàoshī juéde kètáng zhìxù hěn nán wéichí	Some teachers find it difficult to keep order in their classes/to keep their classes in order.	6.143
在上届国会中社会党人占优势。	zài shàng jiè guóhuì zhōng shèhuì dǎngrén zhànyōushì	The Socialists were predominant in the last Parliament.	6.143
水汨汨地从塞孔中流下去。	shuǐ Mì Mì dì cóng sāi kǒng zhōngliú xiàqù	The water gurgled as it ran down the plug-hole.	6.143
这条路曲折地沿山坡通往上面。	zǒngtǒng de qìchē yóu mótuōchē jǐngwèi hù xíng	The road twists and turns up the side of the mountain.	6.143
基督教教义和穆斯林教义极为不同。	Jīdūjiào jiàoyì hé Mùsīlín jiàoyì jíwéi bùtóng	Christian and Muslim doctrines are very different.	6.143
这种混合物凝结之後就成了太妃糖。	zhèzhǒng hùnhéwù níngjié zhīhòu jiù chéngle tàifēitáng	The mixture solidifies into toffee.	6.143
我整天忙个不停，疲於奔命。	wǒ zhěngtiān máng gè bùtíng píyúbēnmìng	I’ve been on the run all day and I’m exhausted.	6.143
他们正在凿山建一条隧道。	tāmen zhèngzài záo shān jiàn yī tiáo suìdào	They are digging through the hill to make a tunnel.	6.143
那艘宇宙飞船溅落在太平洋中。	nà sōu yǔzhòufēichuán jiàn luò zài Tàipíng Yáng zhōng	The spacecraft splashed down in the Pacific.	6.143
沿路前行直至有交通灯处。	yánlù qián xíng zhízhì yǒu jiāotōng dēng chǔ	Go down the road till you reach the traffic lights.	6.143
杜鹃在别的鸟巢中产卵。	dùjuān zài biéde niǎocháo zhōng chǎnluǎn	The cuckoo lays its eggs in other birds’ nests.	6.143
苏伊士运河连接著地中海和红海。	Sūyīshì Yùnhé liánjiē zháodì zhōng hǎi hé Hóng Hǎi	The Suez Canal joins the Mediterranean and the Red Sea.	6.143
他们在墓旁脱帽默哀。	tāmen zài mù páng tuō mào mò’āi	They took off their hats by the grave in silent salute.	6.143
英国国民18岁始有选举权。	Yīngguó guómín suì shǐ yǒuxuǎnjǔquán	UK nationals get the vote at 18.	6.143
投球时在摆动之前举起球棒	tóu qiú shí zài bǎidòng zhīqián jǔqǐ qiúbàng	Cocked the bat before swinging at the pitch.	6.143
兼职音乐教师定期到校授课。	jiānzhí yīnyuè jiàoshī dìngqī dào jiào shòukè	Peripatetic music teachers visit the school regularly.	6.143
警方已编制了涉嫌者名单。	jǐngfāng yǐ biānzhì le shèxián zhě míngdān	The police have compiled a list of suspects.	6.143
英国和法国之间隔著英吉利海峡。	Yīngguó hé Fǎguó zhījiān gé zhe Yīngjílì Hǎixiá	England is separated from France by the Channel.	6.143
进入皇宫时先要在入口大厅等候， 由人带领进入正殿。	jìnrù huánggōng shí xiān yào zài rùkǒu dàtīng děnghòu yóu rén dàilǐng jìnrù zhèngdiàn	You have to wait in a large entrance hall before being shown into the court proper.	6.143
丝线一段毛线、粗线或丝线，尤指主要用来缝合钮扣孔的结实丝线	sīxiàn yī duàn máoxiàn cū xiàn huò sīxiàn yóuzhǐ zhǔyào yònglái fénghé niǔkòu kǒng de jiēshi sīxiàn	A length of yarn, cord, or thread, especially a strong silk thread used mainly to bind the edges of buttonholes.	6.143
这份手稿只有专家才看得懂。	zhè fèn shǒugǎo zhǐyǒu zhuānjiā cái kàn dé dǒng	The manuscript requires an expert to understand it.	6.143
别摸那个盘子--烫极了！	bié mō nàge pánzi tàng jíle	Don’t touch that dish it’s very hot！	6.143
那人用斧头把一块木头劈成两半。	nà rén yòng fǔtóu bǎ yīkuài mùtou pī chéng liǎng bàn	The man cleft a block of wood in two with an axe.	6.143
公爵命令仆人把一封信送给国王。	gōngjué mìnglìng púrén bǎ yī fēng xìn sònggěi guówáng	The duke ordered the servant to send a letter to the king.	6.143
旅馆工作人员等到淡季再休假。	lǚguǎn gōngzuòrényuán děngdào dànjì zài xiūjià	Hotel workers wait until the off-season to take their holidays.	6.143
政府已与莫斯科签了一项条约。	zhèngfǔ yǐ yǔ Mòsīkē qiān le yī xiàng tiáoyuē	The Government has signed a treaty with Moscow.	6.143
修路引起周围居民很多怨言。	xiūlù yǐnqǐ zhōuwéi jūmín hěn duō yuànyán	The road-works caused much complaint among local residents.	6.143
岛上逐渐迁入很多欧洲移民。	dǎo shàng zhújiàn qiānrù hěn duō Ōuzhōu yímín	The islands were gradually populated by settlers from Europe.	6.143
羚羊跑起来有时速度惊人。	língyáng pǎo qilai yǒushí sùdù jīngrén	Gazelles can movewith astonishing velocity.	6.143
委员会什麽时候做出裁决？	wěiyuánhuì shí mó shíhou zuòchū cáijué	When will the committee give/make its ruling?	6.143
气球空气外逸而缓缓下降。	qìqiú kōngqì wài yì ér huǎnhuǎn xiàjiàng	The balloon descended gradually as the air came out.	6.143
祖母逝世时他们开始服丧。	zǔmǔ shìshì shí tāmen kāishǐ fúsāng	When grandmother died they went into (ie started to wear) mourning.	6.143
这种金属框受压後容易变形。	zhèzhǒng jīnshǔ kuàng shòu yā hòu róngyì biànxíng	The metal frame tends to twist under pressure.	6.143
预防胜于治疗（治病不如防病）。	yùfáng shèng yú zhìliáo zhìbìng bùrú fáng bìng	Prevention is better than cure.	6.143
数名士兵因英勇而受嘉奖。	shǔ míng shìbīng yīn yīngyǒng ér shòu jiājiǎng	Several soldiers were decorated for bravery.	6.143
圣公会教区委员圣公会教区委员会中推选的两位主要执事之一	shèng gōnghuì jiàoqū wěiyuán shèng gōnghuì jiàoqū wěiyuánhuì zhōng tuīxuǎn de liǎng wèi zhǔyào zhíshì zhīyī	One of two elected chief lay officers of the vestry in the Episcopal Church.	6.154
“怎样申请许可证？”“你得到问讯处打听。”	zěnyàng shēnqǐng xǔkězhèng nǐ dédào wènxùn chǔ dǎting	“How do I apply for this licence?” “You want inquiries.”	6.154
天空慢慢由蓝色变为红色。	tiānkōng mànmàn yóu lánsè biànwéi hóngsè	The sky slowly changed from blue to red.	6.167
每年春天河水把山谷淹没。	měinián chūntiān héshuǐ bǎ shāngǔ yānmò	Every spring the river floods the valley.	6.167
人群慢慢从体育场散去。	rénqún mànmàn cóng tǐyùchǎng sǎn qù	The crowds drifted away from the stadium.	6.167
有个气球从空中飘过。	yǒu gè qìqiú cóng kōngzhōng piāo guò	A balloon floated across the sky.	6.167
该冠军领先十八秒。	gāi guànjūn lǐngxiān shíbā miǎo	The champion is leading by eighteen seconds.	6.167
这场大祸罪责全在公司。	zhè chǎng dàhuò zuìzé quán zài gōngsī	The blame for the disaster has been laid firmly at the company’s door.	6.167
鲜血从伤口中流出。	xiānxuè cóng shāngkǒu zhōng liúchū	Blood was welling(out) from the wound.	6.167
警方正在审讯两个嫌疑犯。	jǐngfāng zhèngzài shěnxùn liǎng gè xiányífàn	The police are interrogating two suspects.	6.167
安得猛士兮守四方？	ān dé měng shì xī shǒu sìfāng	Where will I find brave men to guard the four corners of my land?	6.167
剧间休息时更换布景。	jù jiān xiūxi shí gēnghuàn bùjǐng	The scenes are changed during the interval.	6.167
服用药片很容易， 只须放在口中咽下即可。	fúyòng yàopiàn hěn róngyì zhǐ xū fàng zài kǒu zhōng yànxià jíkě	Taking pills is easy; just put them in your mouth and swallow.	6.167
监察者防止浪费、丢失或不法行为的监察或防护者	jiānchá zhě fángzhǐ làngfèi diūshī huò bùfǎ xíngwéi de jiānchá huò fánghù zhě	One who serves as a guardian or protector against waste, loss, or illegal practices.	6.167
颜料溶解液，展色剂用以稀释颜料至合适浓度的稀释液	yánliào róngjiě yè zhǎn sè jì yòngyǐ xīshì yánliào zhì héshì nóngdù de xīshì yè	A solvent with which paint is thinned to the proper consistency.	6.167
精通一门外语难不难？	jīngtōng yī mén wàiyǔ nán bù nán	Is it difficult to feel at home in (ie confident when using) a foreign language?	6.167
劫匪把钞票一把抢走了。	jiéfěi bǎ chāopiào yī bǎ qiǎngzǒu le	The robber swooped up the banknotes.	6.167
这种导弹由地下发射。	zhèzhǒng dǎodàn yóu dìxià fāshè	The missile is delivered from underground.	6.167
别忙， 有的是时间。	bié máng yǒudeshì shíjiān	Don’t hurry; there’s plenty of time.	6.167
把床单好好泡一泡。	bǎ chuángdān hǎohǎo pào yī pào	Give the sheets a good soak.	6.167
上流阶层社会等级，尤指高等级	shàngliú jiēcéng shèhuìděngjí yóuzhǐ gāo děngjí	Social rank or caste, especially high rank.	6.167
那些组织受到破坏，形成一道疤痕。	nàxiē zǔzhī shòudào pòhuài xíngchéng yīdào bāhén	The tissues have been destroyed and a scar has formed.	6.167
原料费用昂贵使得产品价格居高不下。	yuánliào fèiyòng ángguì shǐde chǎnpǐn jiàgé jūgāobùxià	The high cost of raw materials is keeping prices up.	6.167
等到激动情绪平静下来再说。	děngdào jīdòng qíngxù píngjìng xiàlai zàishuō	Wait until all the excitementhas settled.	6.167
博学使人谦逊，无知使人骄傲。	bóxué shǐ rén qiānxùn wúzhī shǐ rén jiāo’ào	Knowledge makes humble, ignorance makes proud.	6.167
那个国家将要展示埃及木乃伊。	nàge guójiā jiāngyào zhǎnshì Āijí mùnǎiyī	There will be an Egyptian mummy show in that country.	6.167
据说那种植物可用来治肝炎。	jùshuō nàzhǒng zhíwù kě yònglái zhì gānyán	It is said that the plant can be used to treat hepatitis.	6.167
当地超级市场本周烘豆罐头大减价。	dāngdì chāojíshìchǎng běn zhōu hōngdòu guàntou dà jiǎnjià	Baked bean is on offer this week at the local supermarket.	6.167
这一交易需经政府批准。	zhè yī jiāoyì xū jīng zhèngfǔ pīzhǔn	The deal needs the government’s seal of approval.	6.167
隧道顶坍塌（压住工人）。	suìdào dǐng tāntā yā zhù gōngrén	The roof of the tunnel caved in (on the workmen).	6.167
指挥部命令宇宙飞船返回地球。	zhǐhuī bù mìnglìng yǔzhòufēichuán fǎnhuí dìqiú	Mission control ordered the spacecraft to return to earth.	6.167
群众臂挽著臂组成人墙。	qúnzhòng bì wǎn zhe bì zǔchéng rén qiáng	The crowd linked arms to form a barrier.	6.167
劫持者对人质百般侮辱。	jiéchízhě duì rénzhì bǎibān wǔrǔ	The highjackers inflicted all kinds of indignities on their captives.	6.167
与其说成功在于运气不如说是辛勤努力。	yǔqí shuō chénggōng zàiyú yùnqi bùrú shuō shì xīnqín nǔlì	Success lies not so much as in luck as in hard work.	6.167
领土被侵占者瓜分。	lǐngtǔ bèi qīnzhàn zhě guāfēn	The territory was carved up by the occupying powers.	6.167
警方对疑犯昼夜监视。	jǐngfāng duì yífàn zhòuyè jiānshì	The police are keeping the suspects under round-the-clock surveillance.	6.167
美利坚合众国保证合众国各州实行共和政体。	Měilìjiān Hézhòngguó bǎozhèng hézhòngguó gè zhōu shíxíng gònghézhèngtǐ	The United States shall guarantee to every state in this union a republican form of government.	6.167
一片欢呼声欢迎女王莅临。	yīpiàn huānhū shēng huānyíng nǚwáng lìlín	Cheers greeted the arrival of the Queen.	6.167
在这个食谱中， 可用蜂蜜代替食糖。	zài zhège shípǔ zhōng kě yòng fēngmì dàitì shí táng	Honey can substitute for sugar in this recipe.	6.182
他度假归来， 对假日情趣仍津津乐道。	tā dùjià guī lái duì jiàrì qíngqù réng jīnjīnlèdào	He hasn’t stopped enthusing about his holiday since he returned.	6.182
巡道工，护路员受雇保养或巡查铁道的工人	xún dào gōng hù lù yuán shòugù bǎoyǎng huò xúnchá tiědào de gōngrén	A worker employed to maintain or inspect railroad tracks.	6.182
注意间隔， 否则这个标题一行排不下。	zhùyì jiàngé fǒuzé zhège biāotí yīxíng pái bùxià	Be careful with your spacing or you won’t get the heading on one line.	6.182
堆肥腐烂有机体的混合物，如树叶或粪便，用来改善土壤结构并增加土壤养分	duīféi fǔlàn yǒujītǐ de hùnhéwù rú shùyè huò fènbiàn yònglái gǎishàn tǔrǎng jiégòu bìng zēngjiā tǔrǎng yǎngfèn	A mixture of decaying organic matter, as from leaves and manure, used to improve soil structure and provide nutrients.	6.188
那个胖子经常大吃甜食。	nàge pàngzi jīngcháng dàchī tiánshí	The fat man gorged himself constantly with enormous desserts.	6.2
栓皮经常用作绝缘材料。	shuān pí jīngcháng yòngzuò juéyuán cáiliào	Cork is often used for insulation.	6.2
堤岸，小路高出的堤岸或小路，如沿着一条沟渠的堤岸或小路	dī’àn xiǎolù gāo chū de dī’àn huò xiǎolù rú yánzhe yī tiáo gōuqú de dī’àn huò xiǎolù	A raised bank or path, such as one along a canal.	6.2
禽鸟一种鸟，如鸭、鹅、火鸡或野鸡，用作食物或狩猎的猎物	qínniǎo yīzhǒng niǎo rú yā é huǒjī huò yějī yòngzuò shíwù huò shòuliè de lièwù	A bird, such as the duck, goose, turkey, or pheasant, that is used as food or hunted as game.	6.2
一场大火过后，这座建筑剩下的只是一个空壳。	yī chǎng dàhuǒ guòhòu zhè zuò jiànzhù shèngxià de zhǐshì yī gè kōng qiào	All that remained of the building after the fire was an empty shell.	6.2
小树林缺乏茂密下层树丛的小树林或树木群体	xiǎoshùlín quēfá màomì xiàcéng shùcóng de xiǎoshùlín huò shùmù qúntǐ	A small wood or stand of trees that lacks dense undergrowth.	6.2
日落时， 西边天空有一道红晖。	rìluò shí xībiān tiānkōng yǒu yīdào hóng huī	At sunset, there was a bar of red across the western sky.	6.2
木屑床垫填满草杆或木屑的一床薄垫子	mùxiè chuángdiàn tiánmǎn cǎo gān huò mùxiè de yī chuáng báo diànzi	A thin mattress filled with straw or sawdust.	6.2
比赛结束前十分钟罗布森上场替代威尔金斯。	bǐsài jiéshù qián shífēn zhōng luóbù sēn shàngchǎng tìdài wēi ěr jīn sī	Robson came on in place of Wilkins ten minutes before the end of the game.	6.2
军方声称如内乱不平息将实行军管。	jūnfāng shēngchēng rú nèiluàn bùpíng xī jiāng shíxíng jūn guǎn	The army is/are threatening to take over if civil unrest continues.	6.2
他们一步不停地走了过去。	tāmen yī bù bùtíng dì zǒu le guòqu	They walked past without stopping	6.2
别以为我能相信那件事。	bié yǐwéi wǒ néng xiāngxìn nà jiàn shì	You can scarcely expect me to believe that.	6.2
那个坏蛋已被收买。	nàge huàidàn yǐ bèi shōumǎi	That scoundrel has been got at.	6.2
鳝鱼很长而且很难抓住。	shànyú hěn cháng érqiě hěn nán zhuāzhù	Eels are long and difficult to catch.	6.2
男孩很快地跑上楼。	nánhái hěn kuài dì pǎo shànglóu	The boy ran upstairs quickly.	6.2
稍微向上挪一下。	shāowēi xiàngshàng nuó yīxià	Move up a bit.	6.2
烧鱼之前先去掉鱼鳞。	shāo yú zhīqián xiān qùdiào yúlín	Scale the fish before cooking them.	6.2
这种布料十分耐用。	zhèzhǒng bùliào shífēn nàiyòng	This cloth is designed to stand up to a lot of wear and tear.	6.2
落日把云霞映得通红。	luòrì bǎ yún xiá yìng dé tōnghóng	The sunset reddened the clouds.	6.2
生活费用上升，老年人最受影响。	shēnghuó fèiyòng shàngshēng lǎoniánrén zuì shòu yǐngxiǎng	Old people are hardest hit by the rising cost of living.	6.2
所有货物一律八五折。	suǒyǒu huòwù yīlǜ bā wǔ zhé	All goods have been marked down by 15%.	6.2
他们平等分担家务。	tāmen píngděng fēndān jiāwù	They share the housework equally between them.	6.2
这帮人正被警方追捕。	zhè bāng rén zhèng bèi jǐngfāng zhuībǔ	The gang is being hunted by the police.	6.2
这个老太婆容易迷糊。	zhège lǎotàipó róngyì míhu	The old lady easily gets confused.	6.2
他们决定开办一家合作社。	tāmen juédìng kāibàn yījiā hézuòshè	They decided to set up a cooperative.	6.2
大雨使场地变得坑坑洼洼。	dàyǔ shǐ chǎngdì biànde kēngkengwāwā	The ground was pitted by the heavy rain.	6.2
财政部原则上反对这些提议。	Cáizhèngbù yuánzéshang fǎnduì zhèxiē tíyì	The Treasury was opposed in principle to the proposals.	6.2
前途似乎有点不妙。	qiántú sìhū yǒudiǎn bùmiào	The future does not seem very hopeful.	6.2
这个男孩被引诱逃学。	zhège nánhái bèi yǐnyòu táoxué	The boy was enticed into playing truant.	6.2
昨晚他们被强盗洗劫一空。	zuówǎn tāmen bèi qiángdào xǐjiéyīkōng	Last night, they were cleaned out by robbers.	6.2
玫瑰花从未如此盛开过。	méiguīhuā cóngwèi rúcǐ shèngkāi guò	The rosebush was never so flowery before.	6.2
这座山海拔1，400米。	zhè zuò shān hǎibá mǐ	This mountain is 1,400 meters above sea level.	6.2
杰克打算勤工俭学读完大学。	Jiékè dǎsuàn qíngōngjiǎnxué dú wán dàxué	Jack planned to work his way through college.	6.2
喜讯传来，人们顿时欢呼起来。	xǐxùn chuánlái rénmen dùnshí huānhū qilai	People broke into cheers at once when they heard the good news.	6.2
二等兵琼斯（因勇敢）被授予维多利亚十字勋章。	èrděng bīng Qióngsī yīn yǒnggǎn bèi shòuyǔ Wéiduōlìyà shízì xūnzhāng	Private Jones was awarded the Victoria Cross (for his gallantry).	6.2
【谚】与其夸夸其谈，不如埋头苦干。	yàn yǔqí kuākuāqítán bùrú máitóukǔgàn	It is better to do well than to say well.	6.2
间接宣传；间接无线电传送	jiànjiē xuānchuán jiànjiē wúxiàndiàn chuánsòng	Black propaganda; black radio transmissions.	6.2
撑竿跳需要长距离助跑。	chēnggāntiào xūyào chángjùlí zhù pǎo	Pole vaulters need long run-ups.	6.2
工会被迫稍稍改变立场。	gōnghuì bèipò shāoshāo gǎibiàn lìchǎng	The union has been forced to slightly modify its position.	6.2
这种木材容易裂。	zhèzhǒng mùcái róngyì liè	This wood cleaves easily.	6.2
该条款内容如下。。。。	gāi tiáokuǎn nèiróng rúxià	The clause reads thus/as follows...	6.2
经济学家预言通货膨胀率将会增长。	jīngjìxuéjiā yùyán tōnghuòpéngzhàng lǜ jiānghuì zēngzhǎng	The economists predicted an increase in the rate of inflation.	6.2
金属遇热则膨胀。	jīnshǔ yù rè zé péngzhàng	If metal gets hot it expands.	6.2
吸烟有害於健康。	xīyān yǒuhài yú jiànkāng	Smoking damages your health.	6.2
腐败与犯罪携手并行。	fǔbài yǔ fànzuì xiéshǒu bìngxíng	Corruption and crime go hand in hand.	6.2
据说该明星病重。	jùshuō gāi míngxīng bìngzhòng	The star is reportedly very ill.	6.2
宪法授予总统宣战权。	xiànfǎ shòuyǔ zǒngtǒng xuānzhàn quán	The constitution vests the president with the power to declare war.	6.2
虽说委员会中的多数赞成这项议案，但还有一些人持不同看法。	suīshuō wěiyuánhuì zhòngdì duōshù zànchéng zhè xiàng yì’àn dàn háiyǒu yīxiē rén chí bùtóng kànfǎ	Although most of members of the committee spoke for the bill, a few still held different views.	6.214
附近没有酒店， 至少据我所知没有。	fùjìn méiyǒu jiǔdiàn zhìshǎo jù wǒ suǒzhī méiyǒu	There’s no pub round here, leastways not that I know of.	6.222
这两种学说之间没有什麽关联。	zhè liǎng zhǒng xuéshuō zhījiān méiyǒu shí mó guānlián	There is a distant connection between the two theories.	6.222
他断断续续地同评论家们口诛笔伐，使得肝火旺盛。	tā duànduànxùxù dì tóng pínglùnjiā men kǒuzhūbǐfá shǐde gānhuǒ wàngshèng	He kept the adrenalin flowing with off-and-on feuds with his critics.	6.222
她反驳说，“一派胡言！”	tā fǎnbó shuō yīpàihúyán	“Nonsense！” she retorted.	6.222
成群的歹徒犯法后栖身于荒山中。	chéngqún de dǎitú fànfǎ hòu qīshēn yú huāng shān zhōng	Bands of outlaws lived in the desolate mountains after breaking the laws.	6.222
他旋动把手， 但门就是打不开。	tā xuán dòng bǎshǒu dàn mén jiùshì dǎ bù kāi	She turned the handle but the door wouldn’t open.	6.222
hour一字的开头字母h不发送气音。	yīzì de kāitóu zìmǔ bù fāsòng qì yīn	The word “hour” is pronounced without an initial aspirate.	6.222
获胜的队扛著队长走出场地。	huòshèng de duì káng zhe duìzhǎng zǒuchū chǎngdì	The winning team chaired their captain off the field.	6.222
路灯在黄昏时开， 拂晓时关。	lùdēng zài huánghūn shí kāi fúxiǎo shí guān	The street lights come on at dusk and go off at dawn.	6.222
河水冲破堤岸， 淹没了山谷。	héshuǐ chōngpò dī’àn yānmò le shāngǔ	The river had burst its banks and flooded the valley.	6.222
今年， 他们已发射了数艘宇宙飞船。	jīnnián tāmen yǐ fāshè le shǔ sōu yǔzhòufēichuán	They have sent up several spaceships this year.	6.222
比率虽有下降， 但微不足道。	bǐlǜ suī yǒu xiàjiàng dàn wēibùzúdào	The rate has fallen by an insignificant (ie too small to be important) amount.	6.222
他注视著那些语句， 茫然不解。	tā zhùshì zhe nàxiē yǔjù mángrán	He stared at the words in complete puzzlement.	6.222
建筑物建筑物，尤指大规模且外观宏伟的建筑物	jiànzhùwù jiànzhùwù yóuzhǐ dàguīmó qiě wàiguān hóngwěi de jiànzhùwù	A building, especially one of imposing appearance or size.	6.222
肥畜养肥备宰的幼畜（如羊羔、牛犊）	féi chù yǎng féi bèi zǎi de yòu chù rú yánggāo niúdú	A young animal, such as a lamb or calf, fattened for slaughter.	6.222
成语通常不能照字面译成另一种语言。	chéngyǔ tōngcháng bùnéng zhào zìmiàn yìchéng lìng yīzhǒng yǔyán	Idioms usually cannot be translated literally in another language.	6.222
装载吨船舶内部容积单位，等于一百立方英尺	zhuāngzài dūn chuánbó nèibù róngjī dānwèi děngyú yī bǎi lìfāng yīngchǐ	A unit of internal capacity of a ship equal to100 cubic feet.	6.222
今日股票交投活跃， 价格看涨。	jīnrì gǔpiào jiāo tóu huóyuè jiàgé kànzhǎng	Share prices were buoyant today in active trading.	6.222
股票市场上人心惶惶， 掀起抛售浪潮。	gǔpiàoshìchǎng shàng rénxīn huánghuáng xiānqǐ pāoshòu làngcháo	Panic on the stock market set off a wave of selling.	6.222
该项预测展望经济前景暗淡，因而股票价格大跌。	gāi xiàng yùcè zhǎnwàng jīngjì qiánjǐng àndàn yīn’ér gǔpiào jiàgé dàdiē	Share price plunge as a result of the gloomy economic forecast.	6.222
芭芭内鸭系由野鸭与普通鸭杂交而成。	bā bā nèi yā xì yóu yěyā yǔ pǔtōng yā zájiāo ér chéng	A barbary duck is a cross between a wild duck and an ordinary duck.	6.222
时间表变动得如此频繁， 似乎没有什麽道理。	shíjiānbiǎo biàndòng dé rúcǐ pínfán sìhū méiyǒu shí mó dàoli	It seems illogical to change the timetable so often.	6.231
你需用泵著实抽吸几分钟， 才能把油箱灌满。	nǐ xū yòng bèng zhe shí chōu xī jǐ fēnzhōng cáinéng bǎ yóuxiāng guàn mǎn	You will need to pump hard for several minutes to fill the tank.	6.231
我再说一遍: 跑道尚未畅通， 不能起飞。	wǒ zàishuō yībiàn pǎodào shàngwèi chàngtōng bùnéng qǐfēi	I repeat: the runway is not clear for take-off.	6.231
没有人想碰到麻烦。	méiyǒu rén xiǎng pèngdào máfan	No one liked to have trouble.	6.25
留心那条狗， 有时候咬人。	liúxīn nà tiáo gǒu yǒushíhou yǎo rén	Be careful of the dog; it sometimes bites people.	6.25
秋天时叶子变黄。	qiūtiān shí yèzi biàn huáng	The leaves turn yellow in autumn.	6.25
克林顿就职美国总统。	Kèlíndùn jiùzhí Měiguó zǒngtǒng	Mr. Clinton was inaugurated as the President of the U.S.A.	6.25
士兵们被迫投降。	shìbīng men bèipò tóuxiáng	The soldiers had to yield.	6.25
他只是短期外出--至多一周。	tā zhǐshì duǎnqī wàichū zhìduō yīzhōu	He’s only away for short periods a week at the longest.	6.25
他一点儿一点儿攒钱直到够买一辆汽车。	tā yīdiǎnr yīdiǎnr zǎn qián zhídào gòu mǎi yī liàng qìchē	He saved money bit by bit until he had enough to buy a car.	6.25
这些幼苗不久将栽到花坛中去。	zhèxiē yòumiáo bùjiǔ jiāng zāi dào huātán zhōng qù	These young plants will soon be ready for bedding in borders.	6.25
今天气温有多少度？ 五十几度（不到六十度[五十度出头]）。	jīntiān qìwēn yǒu duōshao dù wǔshí jǐ dù bùdào liùshí dù wǔshí dù chūtóu	How warm is it today? It’s in the (high/low) fifties.	6.25
那些云彩在山顶上空停留不散。	nàxiē yúncai zài shāndǐng shàngkōng tíngliú bù sǎn	Clouds have settled over the mountain tops.	6.25
水分子含有两个氢原子和一个氧原子。	qū shuǐxìng yī gè yǒujīwù duì shuǐfèn de fǎnyìng ér chǎnshēng de yùndòng	A molecule of water consists of two atoms of hydrogen and one atom of oxygen.	6.25
寺院的墙壁上刻著很多装饰物。	sìyuàn de qiángbì shàng kè zhe hěn duō zhuāngshìwù	Many adornments were carved on the temple walls.	6.25
这些油田产的油以美元定价。	zhèxiē yóutián chǎn de yóu yǐ Měiyuán dìngjià	Oil from these fields is priced in dollars.	6.25
这件连衣裙的料子含80%尼龙。	zhè jiàn liányīqún de liàozi hán nílóng	This dress is 80% nylon.	6.25
这艘船运行多佛--加莱航线。	zhè sōu chuán yùnxíng Duōfó jiā lái hángxiàn	The boat operates on the Dover-Calais run.	6.25
谷物进口量受最高限额的严格控制。	gǔwù jìnkǒu liáng shòu zuìgāoxiàn’é de yángé kòngzhì	Grain imports are controlled by strict quotas.	6.25
该书有库存[已脱销]。	gāi shū yǒu kùcún yǐ tuōxiāo	The book is in/out of stock.	6.25
微小表微小的后缀、单词或名称	wēixiǎo biǎo wēi xiǎode hòuzhuì dāncí huò míngchēng	A diminutive suffix, word, or name.	6.25
法庭判给（他）50000英镑损害赔偿费。	fǎtíng pàn gěi tā Yīngbàng sǔnhài péicháng fèi	The court awarded (him) damages of 50000.	6.25
每次创建或更改一个条目时，会自动按字母顺序排列。	měicì chuàngjiàn huò gēnggǎi yī gè tiáomù shí huì zìdòng àn zìmǔshùnxù páiliè	It is automatically alphabetized every time an entry is created or changed.	6.25
那条河长300公里。	nà tiáo hé cháng gōnglǐ	The river is 300 kilometers in length.	6.25
一本新书即将出版。	yī běn xīn shū jíjiāng chūbǎn	A new book is about to be brought out.	6.25
这本杂志发行量很大。	zhè běn zázhì fāxíng liáng hěn dà	This magazine has a large circulation.	6.25
这些货物质量不好。	zhèxiē huòwù zhìliàng bùhǎo	The goods are of poor quality.	6.25
这棵苹果树很少结果。	zhè kē píngguǒ shù hěn shǎo jiéguǒ	The apple tree is seldom fruitful.	6.25
开拓三十英亩土地	kāituò sānshí yīngmǔ tǔdì	Developing a30-acre tract.	6.25
堡垒往往带有塔楼。	bǎolěi wǎngwǎng dàiyǒu tǎlóu	A fortress often has turrets.	6.25
这些小学生尚未学会正确使用标点符号。	zhèxiē xiǎoxuéshēng shàngwèi xuéhuì zhèngquè shǐyòng biāodiǎnfúhào	The children have not yet learned to punctuate correctly.	6.25
雪花轻轻拍打着窗户。	xuěhuā qīngqīng pāidǎ zhe chuānghu	Snowflakes were patting against the window.	6.25
雇会计划得来。	gù kuàijì huádelái	It would pay (you) to use an accountant.	6.25
渐渐地， 这种货币不再通用。	jiànjiàn dì zhèzhǒng huòbì bùzài tōngyòng	Gradually, this kind of currency fell into disuse.	6.25
穿衣随便，穿着邋遢	chuānyī suíbiàn chuānzhuó lāta	Casual or lounging attire.	6.25
西班牙语与拉丁语近似。	Xībānyáyǔ yǔ Lādīngyǔ jìnsì	Spanish is akin to Latin.	6.25
一场示威游行将要发生。	yī chǎng shìwēiyóuxíng jiāngyào fāshēng	A disorderly demonstration will take place.	6.25
外科医生首先切开血管。	wàikēyīshēng shǒuxiān qiē kāi xuèguǎn	First the surgeon performed the section of the blood vessel.	6.25
这些窗户采光及通风性能良好。	zhèxiē chuānghu cǎiguāng jí tōngfēng xìngnéng liánghǎo	The windows permit light and air to enter.	6.25
这项工程提前完工。	zhè xiàng gōngchéng tíqián wángōng	The project was completed ahead of the schedule.	6.25
观众总计达两万人。	guānzhòng zǒngjì dá liǎng wànrén	The audience totalled20, 000.	6.25
尼罗河三角洲土地肥沃。	Níluó Hé sānjiǎozhōu tǔdì féiwò	There are fertile fields in the Nile Delta.	6.25
狮子长着黄褐色棕毛。	shīzi cháng zhe huánghèsè zōngmáo	A lion has tawny mane.	6.25
消息很快传遍校园。	xiāoxi hěn kuài chuánbiàn xiàoyuán	The news soon went round the campus.	6.25
降低失业率应是头等大事。	jiàngdī shīyèlǜ yīng shì tóuděng dàshì	The reduction of unemployment should be paramount.	6.25
这份职业具有挑战性。	zhè fèn zhíyè jùyǒu tiǎozhàn xìng	This career offers a challenge.	6.25
蜜蜂从花中啜蜜，离开时营营地道谢。	mìfēng cóng huā zhōng chuò mì líkāi shí yíng yíngdì dàoxiè	Bees sip honey from flowers and hum their thanks when they leave.	6.25
政府号召青年义务献血。	zhèngfǔ hàozhào qīngnián yìwù xiànxuè	The government calls on the youth to donate their blood voluntarily.	6.25
【谚】意志就是力量。	yàn yìzhì jiùshì lìliang	Will is power.	6.25
那个英雄英勇绝伦。	nàge yīngxióng yīngyǒng juélún	The hero was dauntless.	6.25
密林深处有群猴子。	mìlín shēnchù yǒu qún hóuzi	There is a group of monkeys in the innermost depths of the forest.	6.25
据报道，这艘客轮与一艘油轮相撞。	jùbàodào zhè sōu kèlún yǔ yī sōu yóulún xiāngzhuàng	The liner is reported to have been in collision with an oil tanker.	6.25
鼓声平稳而缓慢。	gǔshēng píngwěn ér huǎnmàn	The beats of the drum were steady and slow.	6.25
他们企图推翻国王。	tāmen qǐtú tuīfān guówáng	They attempted to overthrow the monarch.	6.25
酸能腐蚀金属。	suān néng fǔshí jīnshǔ	Acids eat into metal.	6.25
铝箔用于包装食物。	lǚbó yòngyú bāozhuāng shíwù	Aluminum foil can be used for wrapping food.	6.25
荒原荒凉、贫瘠或遭到毁坏之土地	huāngyuán huāngliáng pínjí huò zāodào huǐhuài zhī tǔdì	Land that is desolate, barren, or ravaged.	6.25
群众高呼赞成。	qúnzhòng gāohū zànchéng	The crowd roared its approval.	6.25
警方到处搜查逃犯。	jǐngfāng dàochù sōuchá táofàn	The police searched every nook and corner for the escaped criminal.	6.25
那位流行歌曲歌星周围蜂拥著许多歌迷。	nà wèi liúxíng gēqǔ gēxīng zhōuwéi fēngyōng zhe xǔduō gēmí	The pop star was followed by a train of admirers.	6.25
必须办妥某些手续方可移居他国。	bìxū bàntuǒ mǒuxiē shǒuxù fāng kě yíjū tāguó	Certain formalities have to be gone through before one can emigrate.	6.25
公牛怒吼起来。	gōngniú nùhǒu qilai	The bull bellowed angrily.	6.25
该报告毫无真实性。	gāi bàogào háowú zhēnshíxìng	There is not a vestige of truth in the report.	6.25
农场周围榆树成篱。	nóngchǎng zhōuwéi yúshù chéng lí	The farm is fenced in with elms.	6.25
设备中有故障。	shèbèi zhōng yǒu gùzhàng	There’s a bug in the system.	6.25
【谚】与其补救于已然，不如防止于未然。	yàn yǔqí bǔjiù yú yǐrán bùrú fángzhǐ yú wèirán	Prevention is better than cure.	6.25
干旱造成农作物歉收。	gānhàn zàochéng nóngzuòwù qiànshōu	The crops failed because of the drought.	6.25
警方已通知各店主留意伪钞。	jǐngfāng yǐ tōngzhī gè diànzhǔ liúyì wěichāo	The police have warned shopkeepers about the forged banknotes.	6.25
由於将军未能当机立断， 我军已丧失对敌采取行动的主动权。	yóuyú jiāngjūn wèinéng dāngjīlìduàn wǒ jūn yǐ sàngshī duìdí cǎiqǔxíngdòng de zhǔdòng quán	Because of the general’s indecisiveness,our armies have lost the initiative to the enemy.	6.267
沥青混泥土碎石或沙子与沥青的混合物，用于铺路或封层顶	lìqīng hùn nítǔ suìshí huò shāzi yǔ lìqīng de hùnhéwù yòngyú pūlù huò fēng céng dǐng	Mixed asphalt and crushed stone gravel or sand, used for paving or roofing.	6.267
一组某物被分割后其部分、区域或群组之一	yī zǔ mǒuwù bèi fēngē hòu qí bùfen qūyù huò qúnzǔ zhīyī	One of the parts, sections, or groups into which something is divided.	6.273
这所房子并不能防暴风雨--屋顶漏了！	zhè suǒ fángzi bìng bùnéng fáng bàofēngyǔ wūdǐng lòu le	This house isn’t exactly stormproof the roof leaks！	6.273
他们因对手权柄在握， 反抗也没用。	tāmen yīn duìshǒu quánbǐng zàiwò fǎnkàng yě méiyòng	Their opponents had the whip hand and it was useless to resist.	6.273
你们消除分歧， 言归於好罢。	nǐmen xiāochú fēnqí yán guī yú hǎo bà	Settle your differences and be friends again.	6.273
合同中规定屋顶要用红瓦而不用石板瓦。	hétong zhōng guīdìng wūdǐng yào yòng hóng wǎ ér bùyòng shíbǎnwǎ	The contract specifies red tiles, not slates, for the roof.	6.273
各党形成联盟时， 共产党人被排斥在外。	gè dǎng xíngchéng liánméng shí gòngchǎn dǎngrén bèi páichì zàiwài	When the coalition was formed, the Communists were left out in the cold.	6.273
敌人轮番轰炸， 他们仍英勇地抵抗。	dírén lúnfān hōngzhà tāmen réng yīngyǒng dì dǐkàng	They held out bravely against repeated enemy bombing.	6.273
附带说一下，约翰下星期要回家。	fùdài shuō yīxià Yuēhàn xiàxīngqī yào huíjiā	Incidentally, John’s coming home next week.	6.286
那个雕刻家正在雕一个维纳斯雕像。	nàge diāokèjiā zhèngzài diāo yī gè Wéinàsī diāoxiàng	The sculptor is working on a sculpture of Venus.	6.286
卫兵们奉令不得离开岗位。	wèibīng men fèng lìng bùdé líkāi gǎngwèi	The guards were ordered not to leave their posts.	6.286
轰隆一声，大量冰雪从山腰崩落。	hōnglōng yīshēng dàliàng bīngxuě cóng shānyāo bēngluò	The avalanche crashed down the mountainside.	6.286
铁路模型展销会将于星期五举行。	tiělù móxíng zhǎnxiāohuì jiāng yú Xīngqīwǔ jǔxíng	A model railway mart will be held on Friday.	6.286
市民们进行突击，试图冲破包围。	shìmín men jìnxíng tūjī shìtú chōngpò bāowéi	The citizens sallied out in an attempt to break the siege.	6.286
该房子／公路正在施工中。	gāi fángzi gōnglù zhèngzài shīgōng zhōng	The house/highway is in course of construction.	6.286
听众全体起立向演讲者欢呼。	tīngzhòng quántǐ qǐlì xiàng yǎnjiǎng zhě huānhū	The audience rose bodily to cheer the speaker.	6.286
当船徐徐开动时，孩子们欢呼雀跃。	dāng chuán xúxú kāidòng shí háizimen huānhūquèyuè	The children cheered as the ship drew slowly away.	6.286
先天论，天性论先天论，大脑不能从外界信息中产生想法	xiāntiān lùn tiānxìng lùn xiāntiān lùn dànǎo bùnéng cóng wàijiè xìnxī zhōng chǎnshēng xiǎngfǎ	The doctrine that the mind produces ideas that are not derived from external sources.	6.286
但它不想某些酒那样上头。	dàn tā bùxiǎng mǒuxiē jiǔ nàyàng shàngtou	But it do not go to the head as some drinks do.	6.286
这家商行为两名合伙人所拥有。	zhè jiā shāng xíngwéi liǎng míng héhuǒrén suǒ yōngyǒu	The business is owned by two partners.	6.286
这个炉具有几个温度定位挡。	zhège lú jùyǒu jǐge wēndù dìngwèi dǎng	The cooker has several temperature settings.	6.286
层次字节、元素、渠道或一行信息	céngcì zìjié yuánsù qúdào huò yīxíng xìnxī	A bit, an element, a channel, or a row of information.	6.286
这家剧院光顾者寡只好关闭。	zhè jiā jùyuàn guānggù zhě guǎ zhǐhǎo guānbì	The theatre has had to close for lack of support.	6.286
这些圆珠笔零售价为70便士。	zhèxiē yuánzhūbǐ líng shòujià wéi biànshì	These biros retail at/for 70p.	6.286
此段河流严禁外人捕鱼。	cǐ duàn héliú yánjìn wàirén bǔyú	The fishing in this stretch of the river is strictly preserved.	6.286
饭前不要吃糖以免影响食欲。	fàn qián bùyào chī táng yǐmiǎn yǐngxiǎng shíyù	Don’t spoil your appetite by eating sweets before meals.	6.286
马戏团主管把鞭子抽得很响。	wǒ xiàng tā biǎodá le chéngzhì de wènhòu	The circus manager snapped his whip.	6.286
一个干部必须联系群众，同群众打成一片。	yī gè gànbù bìxū liánxì qúnzhòng tóng qúnzhòng dǎchéngyīpiàn	A cadre must reach out to and be one with the masses.	6.286
观点十分明确， 无须解释。	guāndiǎn shífēn míngquè wúxū jiěshì	The proposition is so clear that it needs no explanation.	6.286
卫生当局正调查这件事。	wèishēng dāngjú zhèng diàochá zhè jiàn shì	The health authorities are investigating the matter.	6.286
税收使英国各阶层均感压迫。	shuìshōu shǐ Yīngguó gè jiēcéng jūn gǎn yāpò	Taxation bears heavily on all classes in Britain.	6.286
骚乱恶化，政府只得宣布进入紧急状态。	sāoluàn èhuà zhèngfǔ zhǐdé xuānbù jìnrù jǐnjízhuàngtài	The rioting grew worse and the government declared a state of emergency.	6.286
这家工厂将原油加工成汽油。	zhè jiā gōngchǎng jiāng yuányóu jiāgōng chéng qìyóu	The plant converts crude oil into gasoline.	6.286
尼任斯基对演技精益求精一丝不苟。	ní rèn sī jī duì yǎnjì jīngyìqiújīng yīsībùgǒu	Nijinsky was unsparing in his demands for perfection.	6.286
酬金将与工作量成比例。	chóujīn jiāng yǔ gōngzuòliàng chéng bǐlì	Payment will be proportional to the amount of work done.	6.286
劫案发生後警方立即跟踪追击。	jié àn fāshēng hòu jǐngfāng lìjí gēnzōng zhuījī	After the robbery the police immediately gave chase.	6.286
军队从山里开出， 进入宽阔平原。	jūnduì cóng shān lǐ kāi chū jìnrù kuānkuò píngyuán	The army debouched from the mountains into a wide plain.	6.3
这位下级行政官员急不可待地想晋升，但他知道只有待某人死后或退休后才能步其后尘，谋取其职。	zhèwèi xiàjí xíngzhèng guānyuán jíbùkědài dì xiǎng jìnshēng dàn tā zhīdào zhǐyǒu dài mǒurén sǐhòu huò tuìxiū hòu cáinéng bù qíhòu chén móuqǔ qí zhí	The junior executive was impatient for promotion but knew that he would only get it by stepping into a dead man’s shoes.	6.3
莱思角加拿大纽芬兰省东南部一海角，位于亚法隆半岛沿岸	lái sī jiǎo Jiānádà Niǔfēnlán shěng dōngnánbù yī hǎijiǎo wèiyú yà fǎ lóng bàndǎo yán’àn	A promontory of southeast Newfoundland, Canada, on the coast of the Avalon Peninsula.	6.3
他陷於绝望， 终於自杀了。	tā xiànyú juéwàng zhōng yú zìshā le	He surrendered (himself) to despair and eventually committed suicide.	6.3
成群的歹徒犯法後栖身於树林中。	chéngqún de dǎitú fànfǎ hòu qīshēn yú shùlín zhōng	Bands of outlaws lived in the forest.	6.3
公路干线遭水淹没，我们只得择乡间小径绕行。	gōnglù gànxiàn zāo shuǐ yānmò wǒmen zhǐdé zé xiāngjiān xiǎojìng ràoxíng	The main road was flooded so we had to go round by narrow country lanes.	6.3
一声惊雷过後， 狂风暴雨突然袭来。	yīshēng jīngléi guò hòu kuángfēngbàoyǔ tūrán xí lái	There was a crash of thunder, then the storm struck.	6.3
雪融化时， 山间溪流变成山洪暴发。	xuě rónghuà shí shān jiān xīliú biànchéng shānhóng bàofā	When the snow melts, the mountain stream becomes a deluge.	6.3
士兵死亡後， 女眷表示沉痛哀悼。	shìbīng sǐwáng hòu nǚjuàn biǎoshì chéntòng āidào	The dead soldiers were mourned by their womenfolk.	6.3
棺材架，尸体架埋葬前用以放置尸体或棺材的架子	guāncai jià shītǐ jià máizàng qián yòngyǐ fàngzhì shītǐ huò guāncai de jiàzi	A stand on which a corpse or a coffin containing a corpse is placed before burial.	6.308
千万不要照牌价购买汽车， 总得讲讲价才是。	qiānwàn bùyào zhào páijià gòumǎi qìchē zǒngděi jiǎng jiǎngjià cái shì	Never pay the advertised price for a car; always try to bargain.	6.308
推土机一种可用来挖掘或推动泥土机器，如推土机或挖土机	tuītǔjī yīzhǒng kě yònglái wājué huò tuīdòng nítǔ jīqì rú tuītǔjī huò wātǔjī	A machine, such as a bulldozer or backhoe, that is used for digging or pushing earth.	6.308
农药，农用化学品用来增加作物产量的化学品，如激素、杀菌剂、杀虫剂	nóngyào nóng yòng huàxuépǐn yònglái zēngjiā zuòwù chǎnliàng de huàxuépǐn rú jīsù shājūnjì shāchóngjì	A chemical, such as a hormone, a fungicide, or an insecticide, that improves the production of crops.	6.308
拉丁语系， 例如法语， 意大利语， 都起源于拉丁语。	lādīng yǔxì lìrú Fǎyǔ Yìdàlìyǔ dōu qǐyuán yú Lādīngyǔ	The Roman languages such as French, Italian, are all derived from Latin.	6.308
该国对汽车工业严加保护， 外国汽车甚为罕见。	gāi guó duì qìchē gōngyè yánjiā bǎohù wàiguó qìchē shènwéi hǎnjiàn	The country’s car industry is so strongly protected that foreign cars are rarely seen there.	6.308
替捕的一垒安打；第二垒替补偷击	tì bǔ de yī lěi āndǎ dì’èr lěi tìbǔ tōu jī	A pinch single; a pinch steal of second base.	6.333
记住， 火车半夜离开。	jìzhu huǒchē bànyè líkāi	Please bear in mind that the train leaves at midnight.	6.333
公爵用一根羽毛笔写信。	gōngjué yòng yī gēn yǔmáobǐ xiěxìn	The duke wrote a letter with a quill pen.	6.333
地板已用砂纸磨光。	dìbǎn yǐ yòng shāzhǐ móguāng	The floor has been sanded smooth.	6.333
碳精棒常用于电弧灯。	tàn jīng bàng chángyòng yú diànhú dēng	The stick of carbon is often used in an electric arc lamp.	6.333
我得找些零碎东西捐给教堂作义卖。	wǒ dé zhǎo xiē língsuì dōngxi juāngěi jiàotáng zuò yìmài	I must look out some bits and pieces for the church jumble sale.	6.333
这些树是每隔20英尺栽种一棵的。	zhèxiē shù shì měigé yīngchǐ zāizhòng yī kē de	The trees were planted at 20 ft intervals.	6.333
服下这些药丸可保你睡一宿好觉。	fú xià zhèxiē yàowán kě bǎo nǐ shuì yī sù hǎo jué	These pills should ensure you a good night’s sleep.	6.333
这些就是：一些法国法郎，瑞士法郎，美圆和一些荷兰盾。	zhèxiē jiùshì yīxiē Fǎguó fǎláng Ruìshìfǎláng Měiyuán hé yīxiē Hélándùn	Here it is, some French francs, Swiss francs, American dollars and a few Dutch guilders.	6.333
他们在围墙下面挖地道通向远处林中。	tāmen zài wéiqiáng xiàmian wā dìdao tōngxiàng yuǎnchù lín zhōng	They tunnelled along under the walls and up into the woods beyond.	6.333
助学金削减後， 学生人数大大减少。	zhù xué jīn xuējiǎn hòu xuésheng rénshù dàdà jiǎnshǎo	Student numbers have been decimated by cuts in grants.	6.333
她咽下眼泪， 强作笑容。	tā yànxià yǎnlèi qiáng zuò xiàoróng	She gulped back her tears and tried to smile.	6.333
集市的景象光怪陆离， 纷然杂陈。	jíshì de jǐngxiàng guāngguàilùlí fēn rán zá chén	The bazaar was a kaleidoscope of strange sights and impressions.	6.333
把这些次货退还给厂家。	bǎ zhèxiē cìhuò tuìhuán gěi chǎngjiā	Send these faulty goods back to the manufacturer.	6.333
蛇盘绕在树上。	shé pánrào zài shù shàng	The snake coiled itself around the tree.	6.333
闭幕式将于三月二十五日举行。	bìmùshì jiāng yú Sānyuè èrshí wǔ rì jǔxíng	The closing ceremony is going to be held on March 25th.	6.333
本市每年举行一次夏季音乐节。	běnshì měinián jǔxíng yīcì xiàjì yīnyuèjié	This city has a music festival every summer.	6.333
把棍子慢慢插进洞里。	bǎ gùnzi mànmàn chājìn dòng lǐ	Work the stick into the hole.	6.333
这是革新时期。	zhè shì géxīn shíqī	It was a period of innovation.	6.333
信中夹钞票最好寄挂号。	xìn zhōng jiā chāopiào zuìhǎo jì guàhào	It’s wise to register letters containing banknotes.	6.333
建筑费用涨到高达新台币两千万。	jiànzhù fèiyòng zhǎngdào gāodá Xīntáibì liǎng qiānwàn	Building costs ran up to as much as NT$ 20 million.	6.333
高潮即将来到。	gāocháo jíjiāng láidào	A climax is pending.	6.333
他们把原木锯成一块块厚板。	tāmen bǎ yuánmù jù chéng yīkuài kuài hòu bǎn	They are sawing a log into planks.	6.333
干沙吸收水份。	gàn shā xīshōu shuǐ fèn	Dry sand absorbs water.	6.333
烈日照射著这个地方。	lièrì zhàoshè zhe zhège dìfang	The hot sun shone down on the scene.	6.333
不要崇拜财富。	bùyào chóngbài cáifù	Don’t make an idol of money.	6.333
血红蛋白尿尿液中出现血红蛋白	xuèhóngdànbái niào niàoyè zhōng chūxiàn xuèhóngdànbái	The presence of hemoglobin in the urine.	6.333
这次聚会单调乏味。	zhè cì jùhuì dāndiàofáwèi	The party was a dull affair.	6.333
该公路与铁路平行。	gāi gōnglù yǔ tiělù píngxíng	The road runs parallel with the railway.	6.333
这所房子不时进行扩建。	zhè suǒ fángzi bùshí jìnxíng kuòjiàn	The house has been added to (ie New rooms, etc have been built on to it) from time to time.	6.333
手术不能延缓。	shǒushù bùnéng yánhuǎn	The operation cannot wait.	6.333
人们请求政治避难。	rénmen qǐngqiú zhèngzhìbìnàn	The people ask for political asylum.	6.333
人群怒吼著表示不满。	rénqún nùhǒu zhe biǎoshì bùmǎn	The crowd howled its displeasure.	6.333
劳资双方之间存在大量矛盾。	láozī shuāngfāng zhījiān cúnzài dàliàng máodùn	There is a great deal of friction between the management and the work force.	6.333
雄鹰展开双翅。	xióngyīng zhǎnkāi shuāng chì	The eagle unfolded its wings.	6.333
人们穿著古装参加游行。	rénmen chuānzhuó gǔzhuāng cānjiā yóuxíng	People wore historical costumes for the parade.	6.333
这场事故众所周知。	zhè chǎng shìgù zhòngsuǒzhōuzhī	This accident is widely known.	6.333
拍照时照相机不要晃。	pāizhào shí zhàoxiàngjī bùyào huàng	Try not to jerk the camera when taking a photograph.	6.333
据说由于原材料市场上升且捉摸不定，制革商们不愿报出实盘。	jùshuō yóuyú yuáncáiliào shìchǎng shàngshēng qiě zhuōmō bùdìng zhì gé shāng men bùyuàn bào chū shí pán	The tanner is said to be reluctant to quote firm price because of a rising and uncertain raw material market.	6.333
目前生意萧条不振。	mùqián shēngyì xiāotiáo bùzhèn	Business is slack just now.	6.333
下岗职工陷入贫困。	xiàgǎng zhígōng xiànrù pínkùn	Laid-off workers fall into penury.	6.333
农场主雇佣3名工人收割庄稼。	nóngchǎng zhǔ gùyōng míng gōngrén shōugē zhuāngjia	The farmer paid 3 laborers to gather the crop.	6.333
该国南部大雨滂沱而北部却滴雨未落。	gāi guó nánbù dàyǔ pāngtuó ér běibù què dī yǔ wèi luò	The heavy rain missed the north of the country altogether, and the south copped the lot.	6.333
氢极易爆炸。	qīng jí yì bàozhà	Hydrogen is highly explosive.	6.333
他们主动捐款支援此事。	tāmen zhǔdòng juānkuǎn zhīyuán cǐ shì	They pitched in with contributions of money.	6.333
所有债务均已合并。	suǒyǒu zhàiwù jūn yǐ hébìng	All the debts have been consolidated.	6.333
该案因证据不足而撤销。	gāi àn yīn zhèngjù bùzú ér chèxiāo	The case was dismissed because of insufficient evidence.	6.333
庄稼已妥善收获完毕。	zhuāngjia yǐ tuǒshàn shōuhuò wánbì	The harvest has been safely gathered in.	6.333
集体用膳食堂	jítǐ yòngshàn shítáng	A mess hall.	6.333
王子自始至终忠贞不渝。	wángzǐ zìshǐzhìzhōng zhōngzhēnbùyú	The prince remained loyal throughout.	6.333
罢工者游行通过市中心。	bàgōng zhě yóuxíng tōngguò shìzhōngxīn	The strikers paraded through the city centre.	6.333
谈判陷入僵局。	tánpàn xiànrù jiāngjú	The negotiations have reached deadlock.	6.333
旗帜迎风飘扬。	qízhì yíngfēng piāoyáng	A flag ruffled in the breeze.	6.333
罢工者与雇主已达成协议。	bàgōng zhě yǔ gùzhǔ yǐ dáchéngxiéyì	The strikers have reached a settlement with the employers.	6.333
调停调解争端	tiáotíng tiáojiě zhēngduān	Mediation in a dispute.	6.333
患者头部受击後患严重脑震荡。	huànzhě tóubù shòu jī hòu huàn yánzhòng nǎozhèndàng	The patient is suffering from severe concussion following a blow to the head.	6.333
变形形状扭曲	biànxíng xíngzhuàng niǔqū	A distortion in shape.	6.333
深景尤指人透过如两排建筑或树木之间空隙看到的远景或视觉感受	shēn jǐng yóuzhǐ rén tòuguò rú liǎng pái jiànzhù huò shùmù zhījiān kòngxì kàn dào de yuǎnjǐng huò shìjué gǎnshòu	A distant view or prospect, especially one seen through an opening, as between rows of buildings or trees.	6.353
自耦变压器一种电力变压器，其初级线圈与次级线圈部分或全部共用	zì ǒu biànyāqì yīzhǒng diànlì biànyāqì qí chūjí xiànquān yǔ cìjí xiànquān bùfen huò quánbù gòngyòng	An electrical transformer in which the primary and secondary coils have some or all windings in common.	6.357
蓝色染料，蓝色颜料加上这种色彩的色素或颜料	lánsè rǎnliào lánsè yánliào jiāshàng zhèzhǒng sècǎi de sèsù huò yánliào	A pigment or dye imparting this hue.	6.364
焦炭渣，煤屑焦炭或木炭做成后剩下的渣滓	jiāotàn zhā méixiè jiāotàn huò mùtàn zuò chéng hòu shèngxià de zhāzǐ	The refuse left when coke or charcoal is made.	6.364
发动机发出一阵轧轧声， 随即停了下来。	fādòngjī fāchū yīzhèn yàyà shēng suíjí tíng le xiàlai	The engine gave forth a grinding noise, then stopped.	6.364
我见希尔夫人面熟， 但并不相识。	wǒ jiàn Xī’ěr fūren miànshú dàn bìngbù xiāngshí	I know Mrs Hill by sight, but we’ve never met.	6.364
悬挂式滑翔机藉著暖气流在高空飞行。	xuánguàshìhuáxiángjī jièzhe nuǎn qìliú zài gāokōng fēixíng	Currents of warm air keep the hang-gliders aloft.	6.364
矿渣诸如砂砾或矿渣等物质，可从中提取金属	kuàngzhā zhūrú shālì huò kuàngzhā děng wùzhì kě cóngzhōng tíqǔ jīnshǔ	Material, such as gravel or slag, from which metal is extracted in mining.	6.364
消防队到达时， 整座建筑物正在熊熊燃烧著。	xiāofángduì dàodá shí zhěng zuò jiànzhùwù zhèngzài xióngxióng ránshāo zhe	When the firemen arrived the whole building was blazing.	6.364
天主教徒透过告解以获得赦罪[净化灵魂]。	Tiānzhǔjiàotú tòuguò gàojiě yǐ huòdé shèzuì jìnghuà línghún	Catholics go to confession to be purged of sin/purge (away) their sin/purge their souls of sin.	6.364
这个公司做买卖赚钱[赔钱]。	wǒmen cóng Shānshàng fǔkàn xiàmian de shāngǔ	The firm is trading (ie doing business) at a profit/loss.	6.375
孩子们撕开蚕茧看看里面有没有蛹。	háizimen sī kāi cánjiǎn kànkan lǐmiàn yǒu méiyǒu yǒng	The children tore the cocoon open to see if there was a pupa.	6.375
这个铁匠给铁棒加热，直到烧红为止。	zhège tiějiang gěi tiěbàng jiārè zhídào shāohóng wéizhǐ	The blacksmith heated the iron bar until it glowed.	6.375
这个星期天浸信会教友将要举行一场典礼。	zhège Xīngqītiān jìnxìnhuì jiàoyǒu jiāngyào jǔxíng yī chǎng diǎnlǐ	The Baptist will hold a ceremony this Sunday.	6.375
锅炉内壁要洗刷一下，除去钙质沉淀物。	guōlú nèi bì yào xǐshuā yīxià chúqù gàizhì chéndiànwù	The boilers will have to be scoured out to remove the calcium deposits.	6.375
草原向四周伸展， 一望无际。	cǎoyuán xiàng sìzhōu shēnzhǎn yīwàngwújì	The prairies stretch on all sides as far as the eye can see.	6.375
快速巡逻艇迅即赶上那艘旧货船。	kuàisù xúnluótǐng xùnjí gǎnshàng nà sōu jiùhuò chuán	The fast cruiser soon overhauled the old cargo boat.	6.375
教士将鬼从房屋中驱走。	jiàoshì jiāng guǐ cóng fángwū zhōng qūzǒu	A priest exorcized the ghost from the house.	6.375
约翰感到难以为一家大小置备衣着。	Yuēhàn gǎndào nán yǐwéi yījiā dàxiǎo zhì bèi yīzhuó	John felt it hard to rig out his family.	6.375
人们抵受不住酷热而纷纷倒下。	rénmen dǐ shòu bùzhù kùrè ér fēnfēn dǎoxià	Men were dropping like flies in the intense heat.	6.375
小船稳稳地顺著运河突突地航行。	xiǎochuán wěn wěn dì shùn zhe yùnhé tūtū dì hángxíng	The boat chugged along the canal.	6.375
英镑对美元保持稳定，但对日元则疲软。	Yīngbàng duì Měiyuán bǎochí wěndìng dàn duì Rì yuán zé píruǎn	The pound remain firm against the dollar, but fall against the yen.	6.375
石蕊试纸可用以测试溶液是否含酸。	shíruǐshìzhǐ kě yòngyǐ cèshì róngyè shìfǒu hán suān	Litmus paper can be used as an indicator of the presence of acid in a solution.	6.375
公务员须签署遵守公务保密条例。	gōngwùyuán xū qiānshǔ zūnshǒu gōngwù bǎomì tiáolì	Civil Servants are required to sign the Official Secrets Act.	6.375
一滴奶在水中扩散开来， 使水变得混浊不清了。	yī dī nǎi zài shuǐ zhōng kuòsàn kāi lái shǐ shuǐ biànde hùnzhuó bùqīng le	A drop of milk diffused in the water, and it became cloudy.	6.385
剪贴簿，影集，签名薄有空白页以便插入或存放收集品，如邮票、照片或签名的本子	jiǎntiēbù yǐngjí qiānmíng báo yǒukòng bái yè yǐbiàn chārù huò cúnfàng shōují pǐn rú yóupiào zhàopiàn huò qiānmíng de běnzi	A book with blank pages for the insertion and preservation of collections, as of stamps, photographs, or autographs.	6.389
他们说说笑笑，沿着海滩散步。	tāmen shuōshuo xiào xiào yánzhe hǎitān sànbù	They walked along the beach talking and laughing.	6.4
成群结队的犯罪分子整夜横行霸道，令村民们惊恐不已。	chéngqúnjiéduì de fànzuì fēnzǐ zhěngyè héngxíngbàdào lìng cūnmín men jīngkǒng bùyǐ	Groups of law-breakers have been rampaging about all night, putting fear into the villagers.	6.4
开关一种用来控制电路中电流量的电流器件	kāiguān yīzhǒng yònglái kòngzhì diànlù zhōng diàn liúliàng de diànliú qìjiàn	An electrical relay used to control the flow of power in a circuit.	6.4
这种酸乳酪不含人造香料或著色剂。	zhèzhǒng suānrǔlào bù hán rénzào xiāngliào huò zhuósè jì	This yoghurt contains no artificial flavouring or colouring.	6.4
池有机体体内一种贮存流体的液囊或穴	chí yǒujītǐ tǐnèi yīzhǒng zhùcún liútǐ de yè náng huò xué	A fluid-containing sac or cavity in the body of an organism.	6.4
有机氯一种含氯的碳氢化合物杀虫农药，如滴滴涕杀虫剂	yǒujī lǜ yīzhǒng hán lǜ de tànqīnghuàhéwù shāchóng nóngyào rú dīdītì shāchóngjì	Any of various hydrocarbon pesticides, such as DDT, that contain chlorine.	6.4
应该看报以便解时事。	yīnggāi kàn bào yǐbiàn jiě shíshì	You should read the newspapers to keep abreast of current affairs.	6.4
海豹、 海龟、 企鹅均有鳍状肢。	hǎibào hǎiguī qǐ’é jūn yǒu qízhuàngzhī	Seals, turtles and penguins have flippers.	6.4
士兵们仍然固守城堡，但他们已陷于险境。	shìbīng men réngrán gùshǒu chéngbǎo dàn tāmen yǐ xiànyú xiǎnjìng	The soldiers are still holding the fort, but they’re hanging on by their eyelids.	6.4
这一观念一向不太得人心。	zhè yī guānniàn yīxiàng bù tài dé rénxīn	The idea never really took on.	6.4
也许就是路过顺便来看看。	yěxǔ jiùshì lùguò shùnbiàn lái kànkan	Maybe he just came by to drop in.	6.4
书信书信，尤指正式信件	shūxìn shūxìn yóuzhǐ zhèngshì xìnjiàn	A letter, especially a formal one.	6.4
这座剧场一天演出两场。	zhè zuò jùchǎng yī tiān yǎnchū liǎng chǎng	The theater gives two performances a day.	6.4
那个流浪汉不得不乞求钱财。	nàge liúlànghàn bùdébù qǐqiú qiáncái	The vagrant had to beg for money.	6.4
据信这种生物来自外太空。	jùxìn zhèzhǒng shēngwù láizì wàitàikōng	These creatures were believed to have come from outer space.	6.4
6点钟时马达开动起来。	diǎnzhōng shí mǎdá kāidòng qilai	At six o’clock the motor started up.	6.4
开会时间将由班长自行决定。	kāihuì shíjiān jiāng yóu bānzhǎng zìxíng juédìng	The hours of the meetings will be fixed at the monitor’s discretion.	6.4
战时很少交换俘虏。	zhànshí hěn shǎo jiāohuàn fúlǔ	The exchange of prisoners during a war is unusual.	6.4
社会已分化成两个阶级。	shèhuì yǐ fēnhuà chéng liǎng gè jiējí	Society has polarized into two classes.	6.4
从头开始背诵这首诗。	cóngtóu kāishǐ bèisòng zhè shǒu shī	Recite the poem (right) from the (very) beginning.	6.4
登一则招聘广告，也许有用。	dēng yīzé zhāopìn guǎnggào yěxǔ yǒuyòng	Insert a want ad, and it may help.	6.4
警方正进一步寻找线索。	jǐngfāng zhèng jìnyībù xúnzhǎo xiànsuǒ	The police are on the hunt for further clues.	6.4
这种树木可见于平原。	zhèzhǒng shùmù kějiàn yú píngyuán	Such trees can be found in the plains.	6.4
江河大多流入海洋。	jiānghé dàduō liúrù hǎiyáng	Most rivers flow into the sea.	6.4
列车车次已大幅度减少。	lièchē chē cì yǐ dàfúdù jiǎnshǎo	Train services have been cut to the bone.	6.4
以无穷数乘y。	yǐ wúqióng shǔ chéng	Multiply y by infinity.	6.4
总统号召全国人民团结起来。	zǒngtǒng hàozhào quánguó rénmín tuánjié qilai	The President made a call for national unity.	6.4
昨夜隔壁有些异常。	zuóyè gébì yǒuxiē yìcháng	There were some strange goings-on next door last night.	6.4
商业周期就是淡旺期交替。	shāngyè zhōuqī jiùshì dàn wàng qī jiāotì	The business cycle is a series of peaks and troughs.	6.4
黑夜转瞬而至。	hēiyè zhuàn shùn ér zhì	Night was fast approaching.	6.4
运兵船由两艘军舰护航。	yùn bīngchuán yóu liǎng sōu jūnjiàn hùháng	The troop ship was escorted by two warships.	6.4
英雄用剑猛劈巨人。	yīngxióng yòng jiàn měng pī jùrén	The hero smote the giant with his sword.	6.4
泥土中有许多蠕虫。	nítǔ zhōng yǒu xǔduō rúchóng	There are a lot of worms in the soil.	6.4
渔船沿着岸抛锚停泊。	yúchuán yánzhe àn pāomáo tíngbó	Fishing boats were anchored all along the coast.	6.4
资方有权拒绝接纳。	zīfāng yǒuquán jùjué jiēnà	The management reserves the right to refuse admission.	6.4
那些士兵现驻扎于柏林。	nàxiē shìbīng xiàn zhùzhā yú Bólín	The soldiers are now stationed in Berlin.	6.4
税务局负责徵收所得税。	Shuìwùjú fùzé zhēngshōu suǒdéshuì	The Inland Revenue is responsible for collecting income tax.	6.4
猫用爪子互相抓。	māo yòng zhuǎzi hùxiāng zhuā	The cats clawed at each other.	6.4
他们携带著武器。	tāmen xiédài zhe wǔqì	They were carrying weapons.	6.4
我们将汽车滞销归咎於海外需求量太低。	wǒmen jiāng qìchē zhìxiāo guījiù yú hǎiwài xūqiú liáng tài dī	We blame poor overseas demand for the car’s failure.	6.4
这部小说已由俄文原著改编成无线电广播节目。	zhè bù xiǎoshuō yǐ yóu Éwén yuánzhù gǎi biānchéng wúxiàndiàn guǎngbōjiémù	This novel has been adapted for radio from the Russian original.	6.4
选民转而支持左派。	xuǎnmín zhuǎn’ér zhīchí zuǒpài	Voters have/Voting has swung to the left.	6.4
评委会即将宣布优胜者。	píngwěi huì jíjiāng xuānbù yōushèng zhě	The jury is/are about to announce the winners.	6.4
渡船定期往返于英吉利海峡。	dùchuán dìngqī wǎngfǎn yú Yīngjílì Hǎixiá	Ferryboats ply across the English Channel.	6.4
迪克因野心勃勃而自食其果。	Díkè yīn yěxīn bóbó ér zìshíqíguǒ	Dick fell a prey to his ambition.	6.4
宇宙探索仍处于初级阶段	yǔzhòu tànsuǒ réng chǔyú chūjí jiēduàn	Space exploration is still in its infancy.	6.4
慈善事业依靠自愿捐赠。	císhàn shìyè yīkào zìyuàn juānzèng	Charities rely on voluntary donations/contributions.	6.4
污秽导致疾病丛生。	wūhuì dǎozhì jíbìng cóngshēng	Dirt breeds disease.	6.4
迂回管道用于引导气体或液体绕过其它管道或装置的一种管道或渠道	yūhuí guǎndào yòngyú yǐndǎo qìtǐ huò yètǐ ràoguò qítā guǎndào huò zhuāngzhì de yīzhǒng guǎndào huò qúdào	A pipe or channel used to conduct gas or liquid around another pipe or a fixture.	6.412
搬运器一种用以传送或传导物品的机械或装置	bānyùn qì yīzhǒng yòngyǐ chuánsòng huò chuándǎo wùpǐn de jīxiè huò zhuāngzhì	A mechanism or device by which something is conveyed or conducted.	6.417
该处地势平坦又没有树木， 部队无处隐蔽。	gāi chǔ dìshì píngtǎn yòu méiyǒu shùmù bùduì wúchù yǐnbì	The land was flat and treeless and gave no cover to the troops.	6.417
精制石灰胶泥精制石灰胶泥，用于在灰泥表层涂抹成膜	jīngzhì shíhuī jiāoní jīngzhì shíhuī jiāoní yòngyú zài huīní biǎocéng túmǒ chéng mó	A fine lime cement used as a finishing coat on plaster.	6.417
船员夺船未遂， 均以叛乱罪被枪决。	chuányuán duó chuán wèisuì jūn yǐ pànluànzuì bèi qiāngjué	The crew tried to seize control of the ship, and were shot for mutiny.	6.417
该项预测展望经济前景暗淡， 因而股票价格大跌。	gāi xiàng yùcè zhǎnwàng jīngjì qiánjǐng àndàn yīn’ér gǔpiào jiàgé dàdiē	Share prices plunged as a result of the gloomy economic forecast.	6.417
英国邮局直接转帐制度称为全国邮政通汇转帐制。	Yīngguó yóujú zhíjiē zhuàn zhàng zhìdù chēngwéi quánguó yóuzhèng tōng huì zhuàn zhàng zhì	The British Post Office giro system is called the National Giro/Girobank.	6.417
营长命令士兵们沿铁轨排开。	yíngzhǎng mìnglìng shìbīng men yán tiěguǐ pái kāi	The battalion commander lined his men along the railway.	6.429
歹徒们冲进酒吧胡乱扫射一通。	dǎitú men chōngjìn jiǔbā húluàn sǎoshè yī tōng	The gangster run into the bar and start shooting it up.	6.429
窃贼遭警方用计擒获。	qièzéi zāo jǐngfāng yòng jì qínhuò	The thieves were caught in a police trap.	6.429
四个四分之一可构成一个整体。	sì gè sìfēnzhīyī kě gòuchéng yī gè zhěngtǐ	Four quarters make a whole.	6.429
这场火把城市上空映得一片通红。	zhè chǎng huǒbǎ chéngshì shàngkōng yìng dé yīpiàn tōnghóng	The fire cast a ruddy glow over the city.	6.429
那船逆著潮水缓慢地前进。	nà chuán nì zhe cháoshuǐ huǎnmàn dì qiánjìn	The boat made slow headway against the tide.	6.429
把这些乾豆子泡一夜。	bǎ zhèxiē gān dòuzi pào yī yè	Leave the dried beans to soak overnight.	6.429
那个嫌疑犯被带到警察局问话。	nàge xiányífàn bèi dàidào jǐngchájú wènhuà	The suspect was taken to the police station for questioning.	6.429
把黄油加热，直到变成褐色为止。	bǎ huángyóu jiārè zhídào biànchéng hèsè wéizhǐ	Heat the butter until it browns.	6.429
一辆机车沿着铁道隆隆地驶去。	yī liàng jīchē yánzhe tiědào lónglóng dì shǐ qù	A locomotive pounded down the railway track.	6.429
这些计划终於得以实施。	zhèxiē jìhuà zhōng yú déyǐ shíshī	The plans were finally put into execution.	6.429
这一税收制度一旦施行，必定会危害国民经济。	zhè yī shuìshōu zhìdù yīdàn shīxíng bìdìng huì wēihài guómín jīngjì	This tax can not be introduced without detriment to the economy.	6.429
一切生物均可按等级分类。	yīqiè shēngwù jūnkě àn děngjí fēnlèi	There is a hierarchy in the classification of all living creatures.	6.429
那场旱灾过後疾病丛生。	nà chǎng hànzāi guò hòu jíbìng cóngshēng	Outbreaks of disease occurred in the wake of the drought.	6.429
战胜国要求战败国交付巨额赔款。	zhànshèng guó yāoqiú zhànbài guó jiāofù jù’é péikuǎn	The victorious nations are demanding huge indemnities from their former enemies.	6.429
手泵式四轮小车由一个小马达或一台手泵驱动的小型无篷路轨车	shǒu bèng shì sì lún xiǎochē yóu yī gè xiǎo mǎdá huò yī tái shǒu bèng qūdòng de xiǎoxíng wú péng lù guǐ chē	A small open railroad car propelled by a hand pump or a small motor.	6.438
盖上果酱瓶！ 要不准得招黄蜂。	gàishang guǒjiàng píng yàobù zhǔn dé zhāo huángfēng	Cover the jam！ It’s sure to invite the wasps.	6.444
该独裁者发布命令，将其生日定为公众假期。	gāi dúcáizhě fābù mìnglìng jiāng qí shēngrì dìng wéi gōngzhòng jiàqī	The dictator decreed that his birthday would be a public holiday.	6.444
他们对财富[致富]无大欲望。	tāmen duì cáifù zhìfù wú dà yùwàng	They had little desire for wealth/to get rich.	6.444
因经济衰退状况终止有望，股票价格得以保持高位。	yīn jīngjìshuāituì zhuàngkuàng zhōngzhǐ yǒuwàng gǔpiào jiàgé déyǐ bǎochí gāowèi	Share prices were buoyed up by hopes of an end to the recession.	6.444
德语中有三性: 阳性、 阴性和中性。	Déyǔ zhōng yǒu sān xìng yángxìng yīnxìng hé zhōngxìng	There are three genders in German: masculine, feminine and neuter.	6.455
野禽，猎鸟一种野生的猎鸟，如野鸭、野鹅或鹌鹑	yěqín liè niǎo yīzhǒng yěshēng de liè niǎo rú yěyā yě é huò ānchún	A wild game bird, such as a duck, goose, or quail.	6.455
汽车型号，汽车牌子制成品的型号或牌子，尤指汽车	qìchē xínghào qìchē páizi zhìchéngpǐn de xínghào huò páizi yóuzhǐ qìchē	A model or brand of a manufactured product, especially an automobile.	6.455
总之，唯有当严刑峻罚加之于违法之徒时，才能维持社会安定。	zǒngzhī wéiyǒu dāng yánxíng jùn fá jiāzhī yú wéifǎ zhī tú shí cáinéng wéichí shèhuì āndìng	To sum up, only when strict punishment can be imposed on the lawless, can social stability be maintained.	6.455
秋天树叶由绿色变成黄褐色。	qiūtiān shùyè yóu lǜsè biànchéng huánghèsè	In autumn the leaves change from green to brown.	6.5
这沙土地利於排水， 适於种植块根作物。	zhè shā tǔdì lìyú páishuǐ shì yú zhòngzhí kuàigēn zuòwù	This gravelly soil is well drained and good for growing root crops.	6.5
总有一天我会回到家乡。	zǒngyǒu yī tiān wǒ huì huídào jiāxiāng	I can come back to my hometown some day.	6.5
设法用钱大方一点。	shèfǎ yòngqian dàfang yīdiǎn	Try to be more generous with your money.	6.5
这位老人气得发抖。	zhèwèi lǎorén qì dé fādǒu	The old man quivered with rage.	6.5
这个岛难得有船停靠。	zhège dǎo nándé yǒu chuán tíngkào	The island is seldom, if ever, visited by ships.	6.5
一月份生产率达到最高点。	yīyuèfèn shēngchǎnlǜ dádào zuì gāo diǎn	Productivity peaked in January.	6.5
这是一种抽象物。	zhè shì yīzhǒng chōuxiàng wù	This is a kind of abstraction.	6.5
石块朝四面八方乱飞。	shíkuài cháo sìmiànbāfāng luàn fēi	Stones were flying about in every direction.	6.5
信号响时，人人脱帽致敬。	xìnhào xiǎng shí rénrén tuō mào zhìjìng	Everyone uncovered when the signal sounded.	6.5
【谚】人倒众人踩。	yàn rén dǎo zhòngrén cǎi	If a man once fall, all will tread on him.	6.5
女王正对加拿大进行私人访问。	nǚwáng zhèngduì Jiānádà jìnxíng sīrén fǎngwèn	The Queen is making a private visit to Canada.	6.5
宽为80厘米。	kuān wéi límǐ	The width measurement is 80 cm.	6.5
修筑一条铁路要花费许多劳动力。	xiūzhù yī tiáo tiělù yào huāfèi xǔduō láodònglì	It takes a lot of labor to build a railway.	6.5
撤哈拉大部分地区终年无雨。	chè hǎ lā dàbùfen dìqū zhōngnián wú yǔ	Most of Sahara receives almost no rain at all.	6.5
宇宙之大令人吃惊。	yǔzhòu zhī dà lìngrénchījīng	Distancesin space are quite mind-boggling.	6.5
这些花因缺水而渐渐枯萎。	zhèxiē huā yīn quēshuǐ ér jiànjiàn kūwěi	The flowers are wilting for lack of water.	6.5
那场战争中很多士兵死于那片沼泽地。	nà chǎng zhànzhēng zhōng hěn duō shìbīng sǐ yú nà piàn zhǎozédì	In that war, many soldiers died in that fen area.	6.5
这些商品大量供应。	zhèxiē shāngpǐn dàliàng gōngyìng	These goods are freely available.	6.5
食物中有一些杂质。	shíwù zhōng yǒuyīxiē zázhì	There are some impurities in food.	6.5
窗台上积了灰尘。	chuāngtái shàng jī le huīchén	Dust had collected on the window-sill.	6.5
某些植物具有药物效用。	mǒuxiē zhíwù jùyǒu yàowù xiàoyòng	Certain plants have medicinal (ie healing) properties.	6.5
及时补一针，省得补九针。	jíshí bǔ yī zhēn shěngde bǔ jiǔ zhēn	A stitch in time saves nine.	6.5
无通行证者不得入内。	wú tōngxíngzhèng zhě bùdé rù nèi	There is no admittance without a pass.	6.5
大雨之后常有彩虹。	dàyǔ zhīhòu cháng yǒu cǎihóng	A rainbow is usually seen after a heavy rain.	6.5
该商行於八月份公布会计帐目。	gāi shāngháng yú bāyuèfèn gōngbù kuàijì zhàngmù	The firm publishes its accounts in August.	6.5
晚9时把犯人锁进牢房过夜。	wǎn shí bǎ fànrén suǒ jìn láofáng guòyè	At 9 pm the prisoners are locked in for the night.	6.5
绝大部分党员对极端分子不予理睬。	juédàbùfen dǎngyuán duì jíduānfènzǐ bùyú lǐcǎi	The lunatic fringe is/are ignored by most members of the party.	6.5
他们接受该计画时心怀不满。	tāmen jiēshòu gāi jìhuà shí xīnhuái bùmǎn	Therewas an undercurrent of resentment in their acceptance of the plan.	6.5
军人应当绝对服从命令。	jūnrén yīngdāng juéduì fúcóng mìnglìng	Soldiers are expected to obey their orders without question.	6.5
需刷牙以去除牙斑。	xū shuāyá yǐ qùchú yá bān	It is necessary to remove plaque by brushing one’s teeth.	6.5
酸能刺激胃黏膜。	suān néng cìjī wèi niánmó	Acid irritates the stomach lining.	6.5
时刻尤指关键时刻，危急关头	shíkè yóuzhǐ guānjiàn shíkè wēijí guāntóu	A point in time, especially a critical point.	6.5
鲸鱼被鱼叉射中後潜入水中。	jīngyú bèi yúchā shèzhòng hòu qiánrù shuǐ zhōng	The whale dived as the harpoon struck it.	6.5
勿孤注一掷。	yǎn yán yǎnjing de fāyán	Don’t put all your eggs in one basket.	6.5
解毒剂一种药物复合剂，以前用于解毒	jiědújì yīzhǒng yàowù fùhé jì yǐqián yòngyú jiědú	A medicinal compound formerly used as an antidote for poison.	6.5
冬季贸易不景气。	dōngjì màoyì bùjǐngqì	Trade is slack in winter.	6.5
蟹肉三明治；豆腐三明治	xièròu sānmíngzhì dòufu sānmíngzhì	A crab burger, a tofu burger.	6.5
此案已由上诉法庭转给下级法庭处理。	cǐ àn yǐ yóu shàngsù fǎtíng zhuǎngěi xiàjí fǎtíng chǔlǐ	The case has been remitted from the appeal court to a lesser tribunal.	6.5
几经失败之后，敌军被迫后撤。	jǐjīng shībài zhīhòu díjūn bèipò hòuchè	After several reverses the enemy was forced to retreat.	6.5
石油市场欣欣向荣。	shíyóu shìchǎng xīnxīnxiàngróng	The oil market is enjoying a boom.	6.5
超级市场销售各种货物。	chāojíshìchǎng xiāoshòu gèzhǒng huòwù	The supermarket sells goods of all descriptions.	6.5
行动胜于空谈。	xíngdòng shèng yú kōngtán	Actions speak louder than words.	6.5
那辆货车遭罢工者抵制而无法卸货。	nà liàng huòchē zāo bàgōng zhě dǐzhì ér wúfǎ xièhuò	The lorry had been blacked by strikers and could not be unloaded.	6.5
希腊位于欧洲南部。	Xīlà wèiyú Ōuzhōu nánbù	Greece is located in the south of Europe.	6.5
拮据极度缺乏或贫穷；贫困	jiéjū jídù quēfá huò pínqióng pínkùn	Extreme want or poverty; destitution.	6.5
工会正酝酿著闹事。	gōnghuì zhèng yùnniàng zhe nàoshì	Trouble is brewing in the trade unions.	6.5
石油钻塔现全面开工。	shíyóu zuān tǎ xiàn quánmiàn kāigōng	The oil rig is now fully operative.	6.5
蜜蜂采蜜时常使花受粉。	mìfēng cǎi mì shícháng shǐ huā shòu fěn	Flowers are often fertilized by bees as they gather nectar.	6.5
消息若泄露， 必将有後患。	xiāoxi ruò xièlù bìjiāng yǒu hòu huàn	If the news gets out there’ll be trouble.	6.5
傍晚时地面变凉。	bàngwǎn shí dìmiàn biàn liáng	The ground cools off toward evening.	6.5
此合同无效。	cǐ hétong wúxiào	This contract is null and void.	6.5
【谚】夫善则妻贤。	yàn fū shàn zé qī xián	A good husband makes a good wife.	6.5
女王将亲自授予礼品。	nǚwáng jiāng qīnzì shòuyǔ lǐpǐn	The Queen will make the presentation (ie will hand over the gift) herself.	6.5
总共5。40英镑。	zǒnggòng Yīngbàng	That’s 5.40 in all.	6.5
物价渐趋稳定。	wùjià jiàn qū wěndìng	Prices are steadying.	6.5
特命全权公使派驻国外使馆的特命全权使节，仅低于大使	tè mìng quánquán gōngshǐ pài zhù guówài shǐguǎn de tè mìng quánquán shǐjié jǐn dīyú dàshǐ	A minister plenipotentiary assigned to a foreign embassy, ranking next below the ambassador.	6.538
翼剖面；机翼；翼面一个部件或平面，如机翼、螺旋桨叶、方向舵等，其形状或方位控制稳定性、方向、抬升、冲击或驱动	yì pōumiàn jīyì yì miàn yī gè bùjiàn huò píngmiàn rú jīyì luóxuánjiǎng yè fāngxiàng duò děng qí xíngzhuàng huò fāngwèi kòngzhì wěndìngxìng fāngxiàng tái shēng chōngjī huò qūdòng	A part or surface, such as a wing, propeller blade, or rudder, whose shape and orientation control stability, direction, lift, thrust, or propulsion.	6.542
把整块菜地按两锹深翻挖一遍。	bǎ zhěng kuài càidì àn liǎng qiāo shēn fān wā yībiàn	Dig the whole vegetable plot two spits deep.	6.556
修建这堵高墙作为屏障以防外人闯入。	xiūjiàn zhè dǔ gāo qiáng zuòwéi píngzhàng yǐfáng wàirén chuǎngrù	The high wall was built as a defence against intruders.	6.556
容积，体积大小、体积或容积，常指很大时	róngjī tǐjī dàxiǎo tǐjī huò róngjī cháng zhǐ hěn dà shí	Size, mass, or volume, especially when very large.	6.556
美元突然贬值， 财经专家无不大伤脑筋。	Měiyuán tūrán biǎnzhí cáijīng zhuānjiā wú bùdà shāngnǎojīn	The sudden fall in the value of the dollar has puzzled financial experts.	6.556
危险: 叶片旋转， 注意安全。	wēixiǎn yèpiàn xuánzhuǎn zhùyì ānquán	Danger: rotating blades.	6.556
这篇报道不是颠倒黑白就是含糊其辞。	zhè piān bàodào bùshì diāndǎohēibái jiùshì hánhú qí cí	The report was full of lies and prevarications.	6.571
从长远看， 物价肯定要涨。	cóng chángyuǎn kàn wùjià kěndìng yào zhǎng	In the long run pricesare bound to rise.	6.571
水流经水闸时十分湍急。	shuǐliú jīng shuǐzhá shí shífēn tuānjí	Water went rushing through the lock gates.	6.571
这些收音机制造厂产品打不开销路。	zhèxiē shōuyīnjī zhìzàochǎng chǎnpǐn dǎ bù kāixiāo lù	The producers of the radios could not find a market for them.	6.571
无通行证者不得擅入军事基地。	wú tōngxíngzhèng zhě bùdé shàn rù jūnshìjīdì	You cannot enter a military base without a permit.	6.571
他们燃起篝火防止野兽接近。	tāmen ránqǐ gōuhuǒ fángzhǐ yěshòu jiējìn	They lit a fire to keep wild animals off.	6.571
用意虽好， 考虑欠周。	yòngyì suī hǎo kǎolǜ qiàn zhōu	It was thoughtless if well-meaning.	6.571
他们因资源短缺处境窘迫。	tāmen yīn zīyuán duǎnquē chǔjìng jiǒngpò	They were handicapped by (a) poverty of resources.	6.571
该油漆以粉制品形式出售。	gāi yóuqī yǐ fěn zhìpǐn xíngshì chūshòu	The paint is sold in powdered form.	6.571
怀特霍尔街上流传著谣言。	Huáitè Huò’ěr jiēshang liúchuán zhe yáoyán	Rumours are circulating in Whitehall.	6.571
音响效果经预录後已加入对话中。	yīnxiǎngxiàoguǒ jīng yù lù hòu yǐ jiārù duìhuà zhōng	The sound effects had been pre-recorded and were added to the dialogue.	6.571
这列火车是否直达伦敦？	zhè liè huǒchē shìfǒu zhídá Lúndūn	Does this train go right through to London?	6.6
卢·格里克打一垒	lú gé lǐ kè dǎ yī lěi	Lou Gehrig played first base.	6.6
士兵们背起行装，继续前进。	shìbīng men bèi qǐ xíngzhuāng jìxù qiánjìn	The soldiers shouldered their kit and moved on.	6.6
倘若没有指南针， 可利用星辰引路。	tǎngruò méiyǒu zhǐnánzhēn kě lìyòng xīngchén yǐnlù	If you haven’t a compass, use the stars to guide you.	6.6
请问我该先买哪个品种。	qǐngwèn wǒ gāi xiān mǎi nǎge pǐnzhǒng	Please advise me which item I should buy.	6.6
这种胶水粘不住。	zhèzhǒng jiāoshuǐ zhān bùzhù	This glue doesn’t stick very well.	6.6
一行人分乘三部车子。	yīxíng rén fēn chéng sān bù chēzi	The party separated into three cars.	6.6
地震之后紧跟着就是瘟疫。	dìzhèn zhīhòu jǐn gēnzhe jiùshì wēnyì	Plague came in the wake of earthquake.	6.6
他们有没有投标争取承包合同？	tāmen yǒu méiyǒu tóubiāo zhēngqǔ chéngbāo hétong	Have they put in a bid for the contract?	6.6
这种衣料经得住反复洗涤。	zhèzhǒng yīliào jīng dé zhù fǎnfù xǐdí	This dress material will withstand repeated washing.	6.6
这些玉米秧正茁壮生长。	zhèxiē yùmǐ yāng zhèng zhuózhuàng shēngzhǎng	These corn plants are very vigorous.	6.6
刘厂长主持会议，宣布开会。	Liú chǎngzhǎng zhǔchí huìyì xuānbù kāihuì	Director Liu, in the chair, opened the meeting.	6.6
人们抢著购买股票。	rénmen qiǎng zhe gòumǎi gǔpiào	People rushed to buy the shares.	6.6
四面八方立即伸出援助之手。	sìmiànbāfāng lìjí shēnchū yuánzhùzhīshǒu	Offers of help are coming in thick and fast.	6.6
这台机器日夜运转。	zhè tái jīqì rìyè yùnzhuǎn	This machine operates night and day.	6.6
【谚】遮荫之树不可砍。	yàn zhē yìn zhī shù bùkě kǎn	Do not cut down the tree that gives you shade.	6.6
醋中含有醋酸。	cù zhōng hányǒu cùsuān	Vinegar contains acetic acid.	6.6
股票按超出票面价值出售。	gǔpiào àn chāochū piào miàn jiàzhí chūshòu	Shares are selling at a premium.	6.6
人们陆续进入教堂。	rénmen lùxù jìnrù jiàotáng	The procession moved into the church.	6.6
四个士兵守卫灵柩。	sì gè shìbīng shǒuwèi língjiù	Four soldiers stood guard over the coffin.	6.6
钝剪刀剪不齐。	dùn jiǎndāo jiǎn bù qí	Blunt scissors don’t cut cleanly.	6.6
土豆每磅20便士。	tǔdòu měi bàng biànshì	Potatoes are 20 pence a pound.	6.6
备有目录供索取。	bèi yǒu mùlù gōng suǒqǔ	Catalogues are available on request.	6.6
这辆汽车操纵灵敏。	zhè liàng qìchē cāozòng língmǐn	The car responds well to the controls.	6.6
导弹已偏离轨道。	dǎodàn yǐ piānlí guǐdào	The missile deflected from its trajectory.	6.6
国王加冕，典礼极为壮观。	guówáng jiāmiǎn diǎnlǐ jíwéi zhuàngguān	The king was crowned with great pomp.	6.6
发愁於事无补。	fāchóu yú shì wúbǔ	Fretting about it won’t help.	6.6
汽车常由机器装配。	qìchē cháng yóu jīqì zhuāngpèi	The assembly of cars is often done by machines.	6.6
警方劝嫌疑犯招供。	jǐngfāng quàn xiányífàn zhāogòng	The police persuaded the suspect to talk.	6.6
经急剧通货膨胀之後物价现已趋於平稳。	jīng jíjù tōnghuòpéngzhàng zhīhòu wùjià xiàn yǐ qū yú píngwěn	After a period of rapid inflation, price have now reach a plateau.	6.6
该金属已锈蚀。	gāi jīnshǔ yǐ xiùshí	The metal has corroded (away) because of rust.	6.6
皮革受潮可变质。	pígé shòucháo kě biànzhì	Leather can deteriorate in damp conditions.	6.6
蛾子抖动著翅膀。	ézi dǒudòng zhe chìbǎng	The moth quivered its wings.	6.6
这种新型号赛车於道路测试中时速达100英里。	zhèzhǒng xīn xínghào sàichē yú dàolù cèshì zhōng shísù dá Yīnglǐ	The new sports model achieved 100 miles an hour in road tests.	6.615
反对党已对议案提出几项修正。	fǎnduìdǎng yǐ duì yì’àn tíchū jǐ xiàng xiūzhèng	The Opposition have tabled several amendments to the bill.	6.625
暮色四合， 渐而一片漆黑。	mùsè sì hé jiàn ér yīpiàn qīhēi	Twilight merged into total darkness.	6.625
火灾过後， 寒舍所剩无几。	huǒzāi guò hòu hánshè suǒshèngwújǐ	After the fire, very little remained of my house.	6.625
火警警报响时全体人员应到楼外集合。	huǒjǐng jǐngbào xiǎng shí quántǐrényuán yīng dào lóu wài jíhé	If the fire-alarm goes, staff should assemble outside the building.	6.625
光线暗淡有助於人们松弛精神。	guāngxiàn àndàn yǒuzhùyú rénmen sōngchí jīngshén	Subtle lighting helps people relax.	6.625
女王将爵士头衔授予几位杰出人士。	nǚwáng jiāng juéshì tóuxián shòuyǔ jǐwèi jiéchū rénshì	The Queen conferred knighthood on several distinguished men.	6.625
由於乾旱， 农作物歉收。	yóuyú gānhàn nóngzuòwù qiànshōu	The crops failed because of drought.	6.625
排出物从生命体排生物或废物，如脓、屎、尿等	páichū wù cóng shēngmìng tǐ pái shēngwù huò fèiwù rú nóng shǐ niào děng	Discharge or waste, such as pus or feces, from a living organism.	6.636
他们重逢时， 昔日之明争暗斗旋即死灰复燃。	tāmen chóngféng shí xīrì zhī míngzhēng’àndòu xuánjí sǐhuīfùrán	Their old rivalry soon surfaced when they met again.	6.636
经急剧通货膨胀之後物价现已趋於平稳。	jīng jíjù tōnghuòpéngzhàng zhīhòu wùjià xiàn yǐ qū yú píngwěn	After a period of rapid inflation, prices have now reached a plateau.	6.636
贵方所订购货物之其余部分， 一俟我方进货即可供应。	guìfāng suǒ dìnggòu huòwù zhī qíyú bùfen yī qí wǒfāng jìn huò jíkě gōngyìng	The balance of your order will be supplied when we receive fresh stock.	6.643
士兵们奉命举枪致敬。	shìbīng men fèngmìng jǔ qiāng zhìjìng	The soldiers were ordered to present arms.	6.667
无疑这是真相。	wúyí zhè shì zhēnxiàng	This is beyond doubt the truth.	6.667
不要践踏草地。	bùyào jiàntà cǎodì	Don’t trample on the grass.	6.667
不要忽略枝节问题。	bùyào hūlüè zhījié wèntí	Don’t neglect minor issues.	6.667
那个典礼有点像洗礼仪式。	nàge diǎnlǐ yǒudiǎn xiàng xǐlǐ yíshì	The ceremony was something like a christening.	6.667
你方是否已收到我方汇款？	nǐ fāng shìfǒu yǐ shōudào wǒfāng huìkuǎn	Have you received our remittance?	6.667
疼痛越来越剧烈。	téngtòng yuèláiyuè jùliè	The pain increased in intensity.	6.667
明年将要修建一条超级高速公路。	míngnián jiāngyào xiūjiàn yī tiáo chāojí gāosùgōnglù	A superhighway will be constructed next year.	6.667
讲演者直述要点。	jiǎngyǎn zhě zhí shù yàodiǎn	The speaker came to the point straight away.	6.667
那个女孩穿着婚纱格外美丽动人。	nàge nǚhái chuānzhuó hūnshā géwài měilì dòngrén	The girl is all the more beautiful in her wedding gown.	6.667
不要虚度时光。	bùyào xūdù shíguāng	Don’t loiter your time away.	6.667
那个罪犯找到後就要挨鞭子抽打。	nàge zuìfàn zhǎodào hòu jiùyào āi biānzi chōudǎ	The culprit will be whipped when he is found.	6.667
子弹从枪中射出。	zǐdàn cóng qiāng zhōng shèchū	The bullet was expelled from the gun.	6.667
今年马铃薯丰收。	jīnnián mǎlíngshǔ fēngshōu	The tomatoes have cropped well this year.	6.667
各方请柬纷至沓来。	gèfāng qǐngjiǎn fēnzhìtàlái	Invitations rained in on all sides.	6.667
春天里万物欣欣向荣。	chūntiān lǐ wànwù xīnxīnxiàngróng	Nature is at its best in spring.	6.667
悲哀不招自来。	bēi’āi bù zhāo zìlái	Sorrow comes unsent for.	6.667
少量津贴很少一部分金钱补助、工资或津贴	shǎoliàng jīntiē hěn shǎo yībùfèn jīnqián bǔzhù gōngzī huò jīntiē	A meager monetary allowance, wage, or remuneration.	6.667
哦，实际上没什么。	o shíjìshàng méishénme	Oh, nothing to it, actually.	6.667
教义问答法常用于宗教教学。	jiàoyì wèndá fǎ chángyòng yú zōngjiào jiàoxué	The catechism is used for religious instruction.	6.667
【谚】无蜂则无密，不劳则无酬。	yàn wú fēng zé wú mì bù láo zé wú chóu	No bees, no honey; no work, no money.	6.667
黄金埋藏於地下深处。	huángjīn máicáng yú dìxià shēnchù	The gold lies deep in the earth.	6.667
受礼使人盲目。	shòulǐ shǐ rén mángmù	Gift blind the eyes.	6.667
松树不畏严寒。	sōngshù bùwèi yánhán	The pine trees defy severe cold.	6.667
五星红旗迎风飘扬。	wǔxīnghóngqí yíngfēng piāoyáng	The five-star red flag is fluttering in the wind.	6.667
四季循环交替。	sìjì xúnhuán jiāotì	The seasons follow each other in rotation.	6.667
政府拟推行私有化计画。	zhèngfǔ nǐ tuīxíng sīyǒuhuà jìhuà	The government intends to go ahead with its privatization plans.	6.667
法官判他罚款10 美元。	fǎguān pàn tā fákuǎn Měiyuán	The judge imposed a fine of ten dollars on him.	6.667
懒惰乃万恶之源。	lǎnduò nǎi wàn’èzhīyuán	Idleness is the root of all evil.	6.667
当局是否已得知（此事）？	dāngjú shìfǒu yǐ dézhī cǐ shì	Have the authorities been notified (of this)?	6.667
学杂费昂贵，外国留学生负担不起。	xué záfèi ángguì wàiguó liúxuéshēng fùdānbuqǐ	The tuition and fees fall heavy on the international students.	6.667
他们并非同宗。	tāmen bìngfēi tóng zōng	They are not of the same blood.	6.667
被告被控偷窃。	bèigào bèikòng tōuqiè	The defendant is accused of theft.	6.667
女王将爵士头衔授予几位杰出人士。	nǚwáng jiāng juéshì tóuxián shòuyǔ jǐwèi jiéchū rénshì	The Queen conferred knighthoods on several distinguished men.	6.667
保守党势必接连第三届执政。	bǎoshǒudǎng shìbì jiēlián dì sān jiè zhízhèng	The Tories in their third term will be unstoppable.	6.667
回信免费邮寄至牛津牛津大学出版社宣传部。	huíxìn miǎnfèi yóujì zhì Niújīn Niújīn Dàxué chūbǎnshè Xuānchuánbù	Reply to Publicity Department, FREEPOST, Oxford University Press, Oxford.	6.667
＜大学英语词汇综合测试题＞。	dàxué Yīngyǔ cíhuì zōnghé cèshì tí	“Practice Tests For College English Vocabulary”.	6.667
已达成和解。	yǐ dáchéng héjiě	An amicable settlement was reached.	6.667
千方百计振兴渔业注定徒劳无功。	qiānfāngbǎijì zhènxīng yúyè zhùdìng túláowúgōng	All attempts to revive the fishing industry were foredoomed to failure.	6.667
商品交易兴旺。	shāngpǐn jiāoyì xīngwàng	Trading in commodities was brisk.	6.667
消毒剂灭杀细菌。	xiāodújì miè shā xìjūn	Disinfectant kills germs.	6.667
步兵防守甚佳。	bùbīng fángshǒu shèn jiā	The infantry are defending well.	6.667
我绝不同极端分子来往[与极端主义格格不入]。	wǒ jué bùtóng jíduānfènzǐ láiwǎng yǔ jíduānzhǔyì gégébùrù	I’ll have no truck with extremists/extremism.	6.7
19世纪末， 英国许多政客鼓吹扩张主义。	shìjìmò Yīngguó xǔduō zhèngkè gǔchuī kuòzhāng zhǔyì	Expansionism was advocated by many British politicians in the late 19th century.	6.7
联合王国包括英格兰、 威尔士、 苏格兰、 北爱尔兰。	Liánhéwángguó bāokuò Yīnggélán Wēi’ěrshì Sūgélán BěiÀi’ěrlán	The United Kingdom takes in England, Wales, Scotland and Northern Ireland.	6.7
没有人能想像出全面核子战争的後果。	méiyǒu rén néng xiǎngxiàng chū quánmiàn hézi zhànzhēng de hòuguǒ	Nobody can envisage the consequences of total nuclear war.	6.714
那条鲸鱼不住地用尾巴击水。	nà tiáo jīngyú bùzhù dì yòng wěiba jī shuǐ	The whale thrashed the water with its tail.	6.714
一个上尉指挥一个连队或炮兵连。	yī gè shàngwèi zhǐhuī yī gè liánduì huò pàobīng lián	A captain commands a company or battery.	6.714
对于他们枪杀无辜平民，人们感到义愤填膺。	duìyú tāmen qiāngshā wúgū píngmín rénmen gǎndào yìfèntiányīng	People are indignant by their shooting of innocent civilians.	6.714
十二宫图用于占星术中预测未来。	shí’èrgōng tú yòngyú zhānxīngshù zhōng yùcè wèilái	The zodiac is used in astrology to predict the future.	6.714
希罗宁姆斯·博希是怪诞派绘画大师。	xī luó nìng mǔ sī bó xī shì guàidàn pài huìhuà dàshī	Hieronymus Bosch was a master of the grotesque in painting.	6.714
政府援引国家机密保密法以禁该书。	zhèngfǔ yuányǐn guójiā jīmì bǎomì fǎ yǐ jìn gāi shū	The government has invoked the Official Secrets Act in having the book banned.	6.714
全市居民倾城而出迎接凯旋球队。	quánshì jūmín qīngchéng ér chū yíngjiē kǎixuán qiúduì	The city turned out to welcome back its victorious team.	6.714
俄罗斯运动员囊括体操项目奖牌。	Éluósī yùndòngyuán nángkuò tǐcāo xiàngmù jiǎngpái	The Russians made a clean sweep of (the medals in) the gymnastics events.	6.714
请别为此过于不快。	qǐng bié wèicǐ guòyú bùkuài	Please don’t take it too hard.	6.75
人们崇敬这位圣人。	zhè shuǐlóngtóu hǎo nǐng	The people revered the saint.	6.75
这地微向南面倾斜。	zhè dì wēi xiàngnán miàn qīngxié	The land dips gently to the south.	6.75
旧房大都潮湿。	jiù fáng dàdōu cháoshī	Old houses are often damp.	6.75
务必抽空来坐坐。	wùbì chōukòng lái zuò zuò	Do come round and see us some time.	6.75
海明威常用第一人称写作。	Hǎimíngwēi chángyòng dìyī rénchēng xiězuò	Hemingway often writes in the first person.	6.75
内阁定期开会。	nèigé dìngqī kāihuì	The Cabinet meets regularly.	6.75
地面缓缓向南倾斜。	dìmiàn huǎnhuǎn xiàngnán qīngxié	The land dips gently to the south.	6.75
那座宫殿灯火辉煌。	nà zuò gōngdiàn dēnghuǒ huīhuáng	The palace was ablaze with lights.	6.75
城里谣言四起。	chéng lǐ yáoyán sìqǐ	Rumours swept through the town.	6.75
整天断断续续地下著雨。	zhěngtiān duànduànxùxù dìxià zhe yǔ	It rained on and off all day.	6.75
卫兵派驻在监狱四周。	yǐ pài shìbīng qù zhènyā dòngluàn	Guards were stationed around the prison.	6.75
将军下令部下攻城。	jiāngjūn xiàlìng bùxià gōngchéng	The general commanded his men to attack the city.	6.75
【谚】凡事不可半途而废。	yàn fánshì bùkě bàntú’érfèi	Never do things by halves.	6.75
比利时被称作欧洲战场。	Bǐlìshí bèi chēngzuò Ōuzhōu zhànchǎng	Belgium has been called the cockpit of Europe.	6.75
常春藤沿着墙壁蔓延。	chángchūnténg yánzhe qiángbì mànyán	Ivy crept along the walls.	6.75
今年豆子丰收。	jīnnián dòuzi fēngshōu	The beans cropped well this year.	6.75
地质学书籍或论著	dìzhìxué shūjí huò lùn zhe	A book on geology.	6.75
他们力图根除罪恶。	tāmen lìtú gēnchú zuì’è	They attempted to eradicate crime.	6.75
处于…境地；位于	chǔyú jìngdì wèiyú	Having been placed; located.	6.75
果树；果树栽培者	guǒshù guǒshù zāipéi zhě	Fruit trees; fruit growers.	6.75
人间若有天堂， 非此莫属！	rénjiān ruò yǒu tiāntáng fēi cǐ mò shǔ	If there’s a heaven on earth, this is it！	6.75
该装置将於年底投入生产。	gāi zhuāngzhì jiāng yú niándǐ tóurù shēngchǎn	The device will be in production by the end of the year.	6.75
橙子含有维生素C。	chéngzi hányǒu wéishēngsù	Oranges contain vitamin C.	6.75
刀剑挥舞，旌旗飘扬。	dāo jiàn huīwǔ jīngqí piāoyáng	Swords brandished and banners waved.	6.75
叛乱者被迫投降。	pànluàn zhě bèipò tóuxiáng	The rebels were forced to give in.	6.75
领袖或指挥官；首领	lǐngxiù huò zhǐhuīguān shǒulǐng	A leader or commander; a chief.	6.75
金额共计230美元。	jīn’é gòngjì Měiyuán	The sum came to 230 dollars.	6.75
当局悬赏缉拿歹徒。	dāngjú xuánshǎng jīná dǎitú	The authorities put a price on the outlaw’s head.	6.75
皮疹搔後会恶化。	pízhěn sāo hòu huì èhuà	Scratching exacerbates a skin rash.	6.75
寒风掠过平原。	hán fēng lüèguò píngyuán	Cold winds swept the plains.	6.75
法院判给伤者5000英镑损害赔偿费。	fǎyuàn pàn gěi shāngzhě Yīngbàng sǔnhài péicháng fèi	The court awarded 5000 (in) damages to the injured man.	6.75
步兵防守甚佳。	bùbīng fángshǒu shèn jiā	The infantry is/are defending well.	6.75
违法者必受惩罚。	wéifǎ zhě bì shòuchéngfá	You cannot break the law with impunity.	6.75
好极了！／好极了！／了不起！／妙极了！／好极了！	hǎo jíle hǎo jíle liǎobuqǐ miào jíle hǎo jíle	Great！/Terrific！/Yippee！/Magnificent！/Excellent！	6.778
球迷群情激昂， 一窝蜂涌进球场。	qiúmí qún qíng jī’áng yīwōfēng yǒngjìn qiúchǎng	The fans rushed onto the pitch in an excited mob.	6.778
那些男孩子们渴望下课。	nàxiē nánháizi men kěwàng xiàkè	The boys were itching for the lesson to end.	6.8
他们说那样的话真是可恶。	tāmen shuō nàyàng dehuà zhēnshi kěwù	It’s wicked of them to say such things.	6.8
那个裁判偏向那个队。	nàge cáipàn piānxiàng nàge duì	The umpire showed partiality for that team.	6.8
那个流氓靠行骗为生。	nàge liúmáng kào xíngpiàn wéishēng	The rascal lives on the credulity of the people.	6.8
他们渴望返回家园。	tāmen kěwàng fǎnhuí jiāyuán	They were pining to return home.	6.8
他们相爱逐年加深。	tāmen xiāng’ài zhúnián jiāshēn	Yearby year their affection for each other grew stronger.	6.8
指定，指明指有；标明，指出	zhǐdìng zhǐmíng zhǐ yǒu biāomíng zhǐchū	The act of designating; a marking or pointing out.	6.8
池塘四周耸立着一圈树木。	chítáng sìzhōu sǒnglì zhe yī quān shùmù	A fringe of trees stood round the pool.	6.8
按这个按钮开动引擎。	àn zhège ànniǔ kāidòng yǐnqíng	Press this button to start the engine.	6.8
轮船沉没于波涛下面。	lúnchuán chénmò yú bōtāo xiàmian	The ship sank beneath the waves.	6.8
那些囚犯获赦释放。	nàxiē qiúfàn huò shè shìfàng	The convicts were pardoned and set free.	6.8
蒸汽冷却时凝结成水。	zhēngqì lěngquè shí níngjié chéng shuǐ	Steam condenses into water when cooling down.	6.8
河岸决堤後， 田地遭洪水淹没。	hé’àn juédī hòu tiándì zāo hóngshuǐ yānmò	When the river burst its banks the fields were inundated.	6.8
因矿井已关闭， 镇上一片死气沉沉。	yīn kuàngjǐng yǐ guānbì zhèn shàng yīpiàn sǐqìchénchén	The town is dead now the mine has closed.	6.8
当局已采取措施防止偷税漏税。	dāngjú yǐ cǎiqǔcuòshī fángzhǐ tōushuì lòushuì	The authorities took measures to prevent tax fraud.	6.8
炮火掩护步兵前进。	pàohuǒ yǎnhù bùbīng qiánjìn	Artillery gave cover (ie fired at the enemy to stop them firing back) while the infantry advanced.	6.8
陪审团认定该囚犯无罪。	péishěntuán rèndìng gāi qiúfàn wúzuì	The jury found the prisoner not guilty.	6.8
外面飓风呼啸著。	wàimiàn jùfēng hūxiào zhe	The hurricane screamed outside.	6.8
坦克陷入泥沼之中。	tǎnkè xiànrù nízhǎo zhīzhōng	The tank (got) bogged down in the mud.	6.8
部队进攻敌军防线。	bùduì jìngōng díjūn fángxiàn	The troops charged (at) the enemy lines.	6.8
订费按季度交付。	dìngfèi àn jìdù jiāofù	Subscriptions should be paid quarterly.	6.8
帐款共计30英镑。	zhàng kuǎn gòngjì Yīngbàng	The bill came to 30.	6.8
球队阵容中将没有琼斯。	qiúduì zhènróng zhōngjiàng méiyǒu Qióngsī	Jones will be missing from the team line-up.	6.833
讲课时不要岔开（主题）。	jiǎng kèshí bùyào chàkāi zhǔtí	Don’t digress (from the subject) when lecturing.	6.833
大雨过後有几片耕地被淹。	dàyǔ guò hòu yǒu jǐ piàn gēngdì bèi yān	Several fields are under water after the heavy rain.	6.833
这所小学附属于一所大学。	zhè suǒ xiǎoxué fù shǔyú yī suǒ dàxué	This elementary school is affiliated to a university.	6.833
跨着以便跨过或横过；横跨	kuà zhe yǐbiàn kuàguò huò héngguò héngkuà	So as to straddle or bridge; astride.	6.833
人们叫喊著为选手打气。	rénmen jiàohǎn zhe wéi xuǎnshǒu dǎqì	The crowd yelled (out) encouragement at the players.	6.833
原先那片荒山如今已是果树成荫。	yuánxiān nà piàn huāng shān rújīn yǐ shì guǒshù chéng yìn	The barren hills are crowned with fruit trees.	6.833
衷心祝愿鸿运高照，美满姻缘，天长地久。	zhōngxīn zhùyuàn hóngyùn gāo zhào měimǎn yīnyuán tiānchángdìjiǔ	May this day be start of long happy prosperous life for you both.	6.833
分隔物，分界线分界物或分割物，用作分配或分类	fēngé wù fēnjièxiàn fēn jiè wù huò fēngē wù yòngzuò fēnpèi huò fēnlèi	Something, such as a boundary or partition, that serves to divide or keep separate.	6.833
他们只用天然颜料染毛织品。	tāmen zhǐ yòng tiānrán yánliào rǎn máo zhīpǐn	They used only natural pigments to dye the wool.	6.833
议会定於明日解散。	yìhuì dìngyú míngrì jiěsàn	Parliament dissolves tomorrow.	6.833
风呼啸著穿过树林。	fēng hūxiào zhe chuānguò shùlín	The wind screamed through the trees.	6.833
饮用水均须过滤净化。	yǐnyòngshuǐ jūn xū guòlǜ jìnghuà	All drinking water must be filtered.	6.833
这所中学附属于一所师范院校。	zhè suǒ zhōngxué fù shǔyú yī suǒ shīfàn yuànxiào	This middle school is attached to a teachers’ college.	6.833
30秒钟後发射升空。	miǎozhōng hòu fāshè shēngkōng	Blast-off is in 30 seconds.	6.833
这种建筑风格起源於古希腊。	zhèzhǒng jiànzhù fēnggé qǐyuán yú gǔ Xīlà	The style of architecture originated from/with the ancient Greeks.	6.833
部队已将该城包围。	bùduì yǐ jiāng gāi chéng bāowéi	Troops have surrounded the town.	6.833
循环小数｀3。999。。。＇亦作｀3。9循环＇。	xúnhuánxiǎoshù yìzuò xúnhuán	The recurring decimal 3.999... is also described as 3.9 recurring.	6.833
仇恨常常源於恐惧。	chóuhèn chángcháng yuányú kǒngjù	Hatred often springs from fear.	6.833
这个婴儿打开书本彷佛他会念书。	zhège yīng’ér dǎkāi shūběn fǎng fú tā huì niànshū	The baby opened the book as if he were able to read.	6.857
这些男孩捉弄那位老人真是残忍。	zhèxiē nánhái zhuōnòng nà wèi lǎorén zhēnshi cánrěn	It is very cruel of these boys to make a fool of that old man.	6.857
这个编在什麽标题之下？	zhège biān zài shí mó biāotí zhīxià	What heading does this come under?	6.857
土壤施用杀虫剂後肥力大增。	tǔrǎng shīyòng shāchóngjì hòu féilì dà zēng	The fertility of the soil has been greatly improved by the use of pesticides.	6.857
泰晤士河发源於科茨沃尔德丘陵。	Tàiwùshì Hé fā yuányú Kēcíwò’ěrdé qiūlíng	The Thames rises in the Cotswold Hills.	6.857
这个港口每年货物吞吐量达1亿吨。	zhège gǎngkǒu měinián huòwù tūntǔ liáng dá yì dūn	This port handles 100 million tons of cargo each year.	6.875
两船相撞之後都挣扎著驶进海港。	liǎng chuán xiāngzhuàng zhīhòu dōu zhēngzhá zhe shǐ jìn hǎigǎng	After the collision both vessels managed to limp into harbour.	6.875
数百只小艇随同这艘班轮驶入港湾。	shùbǎi zhǐ xiǎo tǐng suítóng zhè sōu bānlún shǐrù gǎngwān	Hundreds of small craft accompany the liner into harbour.	6.875
亚历山大大帝曾率领大军入侵印度。	Yàlìshāndà Dàdì céng shuàilǐng dàjūn rùqīn Yìndù	Alexander the Great invaded India with a large army.	6.875
探照灯发出强光， 照亮监狱场地。	tànzhàodēng fāchū qiángguāng zhàoliàng jiānyù chǎngdì	The searchlights glared, illuminating the prison yard.	6.889
他们须疏浚运河河道轮船方可通航。	tāmen xū shūjùn yùnhé hédào lúnchuán fāng kětōng háng	They have to dredge the canal so that ships can use it.	6.889
希尔夫人不会客， 但近亲除外。	Xī’ěr fūren bùhuì kè dàn jìnqīn chúwài	Mrs Hill is not at home to anyone except close relatives.	6.9
寻物: 遗失钻戒一枚， 寻得者将获重酬。	xún wù yíshī zuànjiè yī méi xún dé zhě jiāng huò zhòng chóu	Lost: one diamond ring. Finder will be rewarded.	6.923
